Year,AdminCity,City,Population,Male,Female,Latitude,Longitude
2010,Blagoevgrad,Bansko,8562,4258,4304,41.8383,23.488
2010,Blagoevgrad,Belitsa,3091,1469,1622,41.9494,23.5725
2010,Blagoevgrad,Blagoevgrad,70259,33554,36705,42.0167,23.1
2010,Blagoevgrad,Gotse Delchev,19721,9458,10263,41.5667,23.7333
2010,Blagoevgrad,Dobrinishte,2681,1310,1371,41.825,23.5594
2010,Blagoevgrad,Kresna,3428,1708,1720,41.73,23.1569
2010,Blagoevgrad,Melnik,347,206,141,41.5231,23.3925
2010,Blagoevgrad,Petrich,29836,14305,15531,41.3981,23.2072
2010,Blagoevgrad,Razlog,12472,6082,6390,41.8864,23.4678
2010,Blagoevgrad,Sandanski,26959,12930,14029,41.5667,23.2833
2010,Blagoevgrad,Simitli,6781,3353,3428,41.8936,23.1069
2010,Blagoevgrad,Hadzhidimovo,2610,1301,1309,41.5167,23.8667
2010,Blagoevgrad,Yakoruda,5627,2712,2915,42.02,23.6833
2010,Burgas,Aytos,20930,10062,10868,42.7,27.25
2010,Burgas,Aheloy,2183,1095,1088,42.6483,27.6494
2010,Burgas,Ahtopol,1310,645,665,42.1,27.95
2010,Burgas,Burgas,193564,92598,100966,42.4975,27.47
2010,Burgas,Bulgarovo,1819,894,925,42.65,27.3333
2010,Burgas,Kableshkovo,2820,1400,1420,42.6167,27.5667
2010,Burgas,Kameno,4784,2295,2489,42.5667,27.3667
2010,Burgas,Karnobat,18214,8760,9454,42.65,26.9833
2010,Burgas,Kiten,1127,583,544,42.2344,27.7711
2010,Burgas,Malko Tarnovo,2377,1151,1226,41.9833,27.5333
2010,Burgas,Nesebar,12133,6128,6005,42.66,27.72
2010,Burgas,Obzor,2351,1225,1126,42.8167,27.8833
2010,Burgas,Pomorie,13432,6496,6936,42.55,27.65
2010,Burgas,Primorsko,3282,1605,1677,42.2667,27.75
2010,Burgas,Sveti Vlas,3886,2184,1702,42.7167,27.7667
2010,Burgas,Sozopol,5286,2580,2706,42.4167,27.7
2010,Burgas,Sredets,9122,4443,4679,42.3483,27.1933
2010,Burgas,Sungurlare,3282,1604,1678,42.7667,26.7833
2010,Burgas,Tsarevo,5882,2870,3012,42.17,27.85
2010,Burgas,Chernomorets,2204,1130,1074,42.45,27.64
2010,Varna,Aksakovo,7978,3890,4088,43.2592,27.8211
2010,Varna,Beloslav,7878,3896,3982,43.19,27.7
2010,Varna,Byala,2130,1071,1059,42.8833,27.8833
2010,Varna,Byala,2130,1071,1059,43.4631,25.7214
2010,Varna,Varna,321692,155824,165868,43.2167,27.9167
2010,Varna,Valchi Dol,3392,1634,1758,43.4,27.5333
2010,Varna,Devnya,8369,4129,4240,43.2222,27.57
2010,Varna,Dolni Chiflik,6698,3290,3408,42.9833,27.7333
2010,Varna,Dalgopol,4781,2381,2400,43.05,27.35
2010,Varna,Ignatievo,4006,1950,2056,43.3,27.7
2010,Varna,Provadia,12766,6199,6567,43.1833,27.4333
2010,Varna,Suvorovo,4745,2351,2394,43.33,27.6
2010,Veliko Tarnovo,Byala Cherkva,2547,1208,1339,43.15,25.3
2010,Veliko Tarnovo,Veliko Tarnovo,67214,31426,35788,43.0833,25.65
2010,Veliko Tarnovo,Gorna Oryahovitsa,32079,15418,16661,43.1278,25.7019
2010,Veliko Tarnovo,Debelets,4254,2059,2195,43.0333,25.6167
2010,Veliko Tarnovo,Dolna Oryahovitsa,2969,1448,1521,43.1167,25.7833
2010,Veliko Tarnovo,Elena,5623,2706,2917,42.9333,25.8833
2010,Veliko Tarnovo,Zlataritsa,2544,1252,1292,43.05,25.9
2010,Veliko Tarnovo,Kilifarevo,2292,1110,1182,42.9833,25.6333
2010,Veliko Tarnovo,Lyaskovets,8164,3890,4274,43.1111,25.7261
2010,Veliko Tarnovo,Pavlikeni,10850,5317,5533,43.2428,25.3219
2010,Veliko Tarnovo,Polski Trambesh,4470,2234,2236,43.3667,25.65
2010,Veliko Tarnovo,Svishtov,34842,16386,18456,43.6239,25.3531
2010,Veliko Tarnovo,Strazhitsa,5085,2498,2587,43.2333,25.9667
2010,Veliko Tarnovo,Suhindol,2086,1020,1066,43.1833,25.2
2010,Vidin,Belogradchik,5242,2574,2668,43.6278,22.6833
2010,Vidin,Bregovo,2552,1206,1346,44.15,22.65
2010,Vidin,Vidin,48859,23485,25374,43.99,22.8725
2010,Vidin,Gramada,1580,784,796,43.8742,22.6783
2010,Vidin,Dimovo,1188,583,605,43.7417,22.7283
2010,Vidin,Dunavtsi,2730,1369,1361,44.0,22.8667
2010,Vidin,Kula,3220,1520,1700,43.89,22.5217
2010,Vratsa,Byala Slatina,12289,5865,6424,43.4667,23.9333
2010,Vratsa,Vratsa,59870,28653,31217,43.21,23.5625
2010,Vratsa,Kozloduy,13752,6832,6920,43.7833,23.7333
2010,Vratsa,Krivodol,3250,1567,1683,43.3683,23.4936
2010,Vratsa,Mezdra,10769,5095,5674,43.15,23.7
2010,Vratsa,Mizia,3289,1596,1693,43.6867,23.8458
2010,Vratsa,Oryahovo,5331,2535,2796,43.7358,23.9619
2010,Vratsa,Roman,3088,1572,1516,43.1369,24.125
2010,Gabrovo,Gabrovo,59184,28450,30734,42.8747,25.3186
2010,Gabrovo,Dryanovo,7892,3772,4120,42.9747,25.4781
2010,Gabrovo,Plachkovtsi,1854,924,930,42.8333,25.4333
2010,Gabrovo,Sevlievo,23908,11686,12222,43.0275,25.1125
2010,Gabrovo,Tryavna,9569,4526,5043,42.8672,25.5008
2010,Dobrich,Balchik,12127,6016,6111,43.4072,28.1672
2010,Dobrich,General Toshevo,6979,3415,3564,43.7,28.0333
2010,Dobrich,Dobrich,92031,43984,48047,43.5667,27.8333
2010,Dobrich,Kavarna,11340,5499,5841,43.4358,28.3386
2010,Dobrich,Tervel,6682,3284,3398,43.7472,27.41
2010,Dobrich,Shabla,3505,1734,1771,43.535,28.5339
2010,Kardzhali,Ardino,3530,1695,1835,41.5833,25.1333
2010,Kardzhali,Dzhebel,2982,1459,1523,41.4933,25.305
2010,Kardzhali,Krumovgrad,4861,2367,2494,41.4667,25.65
2010,Kardzhali,Kardzhali,45604,21781,23823,41.65,25.3667
2010,Kardzhali,Momchilgrad,7542,3720,3822,41.5258,25.4061
2010,Kyustendil,Bobovdol,5891,3014,2877,42.3522,23.0333
2010,Kyustendil,Boboshevo,1291,587,704,42.1461,23.0708
2010,Kyustendil,Dupnitsa,35506,16927,18579,42.2667,23.1167
2010,Kyustendil,Kocherinovo,2542,1196,1346,42.1167,23.0833
2010,Kyustendil,Kyustendil,45431,21819,23612,42.2833,22.6833
2010,Kyustendil,Rila,2807,1365,1442,42.13,23.3869
2010,Kyustendil,Sapareva Banya,4069,2027,2042,42.2889,23.2672
2010,Lovech,Apriltsi,3121,1551,1570,42.85,24.9167
2010,Lovech,Letnitsa,3577,1689,1888,43.2558,25.0639
2010,Lovech,Lovech,37843,18524,19319,43.1333,24.7167
2010,Lovech,Lukovit,9535,4620,4915,43.2,24.1667
2010,Lovech,Teteven,10429,5181,5248,42.9167,24.2667
2010,Lovech,Troyan,21723,10722,11001,42.89,24.7133
2010,Lovech,Ugarchin,2774,1334,1440,43.1,24.3167
2010,Lovech,Yablanitsa,2855,1410,1445,43.05,24.1
2010,Montana,Berkovitsa,13721,6598,7123,43.2392,23.1272
2010,Montana,Boychinovtsi,1615,824,791,43.4683,23.3044
2010,Montana,Brusartsi,1264,614,650,43.7,23.05
2010,Montana,Valchedram,3696,1752,1944,43.715,23.45
2010,Montana,Varshets,6428,3132,3296,43.1981,23.2875
2010,Montana,Lom,23836,11339,12497,43.8139,23.2369
2010,Montana,Montana,44602,21537,23065,43.4125,23.225
2010,Montana,Chiprovtsi,1862,915,947,43.3844,22.8822
2010,Pazardzhik,Batak,3422,1733,1689,41.9442,24.2181
2010,Pazardzhik,Belovo,3794,1813,1981,42.2122,24.015
2010,Pazardzhik,Bratsigovo,4386,2171,2215,42.0128,24.3742
2010,Pazardzhik,Velingrad,23479,11087,12392,42.0278,23.9908
2010,Pazardzhik,Vetren,3463,1699,1764,42.245,24.0894
2010,Pazardzhik,Kostandovo,4277,2119,2158,42.0656,24.0517
2010,Pazardzhik,Pazardzhik,74850,35984,38866,42.1922,24.3331
2010,Pazardzhik,Panagyurishte,17675,8625,9050,42.5,24.1833
2010,Pazardzhik,Peshtera,19288,9429,9859,42.0347,24.2994
2010,Pazardzhik,Rakitovo,8277,4064,4213,41.9878,24.0861
2010,Pazardzhik,Septemvri,8320,4087,4233,42.2167,24.1
2010,Pazardzhik,Strelcha,4240,2026,2214,42.5,24.3167
2010,Pazardzhik,Sarnitsa,3579,1793,1786,41.7858,24.015
2010,Pernik,Batanovtsi,2247,1083,1164,42.5539,23.0325
2010,Pernik,Breznik,3940,1879,2061,42.7394,22.9078
2010,Pernik,Zemen,1834,883,951,42.48,22.7489
2010,Pernik,Pernik,77879,37074,40805,42.6078,23.0375
2010,Pernik,Radomir,13873,6627,7246,42.5453,22.9775
2010,Pernik,Tran,2492,1244,1248,42.8342,22.6519
2010,Pleven,Belene,8761,4610,4151,43.6511,25.1133
2010,Pleven,Gulyantsi,3372,1628,1744,43.6486,24.7125
2010,Pleven,Dolna Mitropolia,3260,1552,1708,43.4667,24.5333
2010,Pleven,Dolni Dabnik,4706,2311,2395,43.4167,24.4333
2010,Pleven,Iskar,3539,1750,1789,43.4608,24.2686
2010,Pleven,Knezha,11063,5337,5726,43.5,24.0833
2010,Pleven,Koynare,4383,2152,2231,43.3667,24.0833
2010,Pleven,Levski,10528,5132,5396,43.4333,25.1333
2010,Pleven,Nikopol,3832,1896,1936,43.7081,24.8983
2010,Pleven,Pleven,110520,53036,57484,43.4167,24.6167
2010,Pleven,Pordim,2086,1011,1075,43.4167,24.9167
2010,Pleven,Slavyanovo,4342,2134,2208,43.3167,24.8667
2010,Pleven,Trastenik,4460,2180,2280,43.4833,24.55
2010,Pleven,Cherven Bryag,13634,6621,7013,43.2667,24.1
2010,Plovdiv,Asenovgrad,51019,24617,26402,42.0167,24.8667
2010,Plovdiv,Banya,3427,1585,1842,42.5,24.8333
2010,Plovdiv,Brezovo,1858,891,967,42.4833,25.0833
2010,Plovdiv,Kalofer,3191,1510,1681,42.6178,24.98
2010,Plovdiv,Karlovo,23797,11432,12365,42.6333,24.8
2010,Plovdiv,Klisura,1241,592,649,42.7,24.45
2010,Plovdiv,Krichim,8463,4110,4353,42.0333,24.4667
2010,Plovdiv,Kuklen,5837,2824,3013,42.0333,24.7833
2010,Plovdiv,Laki,2406,1327,1079,41.8167,24.8333
2010,Plovdiv,Perushtitsa,5149,2516,2633,42.0333,24.55
2010,Plovdiv,Plovdiv,347611,165477,182134,42.15,24.75
2010,Plovdiv,Parvomay,13733,6482,7251,42.1,25.2167
2010,Plovdiv,Rakovski,15052,7231,7821,42.2833,24.9333
2010,Plovdiv,Sadovo,2491,1250,1241,42.1333,24.8667
2010,Plovdiv,Sopot,9076,4403,4673,42.6667,24.75
2010,Plovdiv,Stamboliyski,11575,5538,6037,42.1333,24.5333
2010,Plovdiv,Saedinenie,5951,2904,3047,42.25,24.6
2010,Plovdiv,Hisarya,7239,3459,3780,42.5,24.7
2010,Razgrad,Zavet,3316,1662,1654,43.7333,26.5833
2010,Razgrad,Isperih,8829,4247,4582,43.7167,26.8333
2010,Razgrad,Kubrat,7898,3784,4114,43.8,26.5
2010,Razgrad,Loznitsa,2361,1201,1160,43.4333,26.6167
2010,Razgrad,Razgrad,34157,15908,18249,43.5333,26.5167
2010,Razgrad,Tsar Kaloyan,3782,1803,1979,43.6333,26.2333
2010,Ruse,Borovo,2275,1111,1164,43.5667,25.8167
2010,Ruse,Byala,8890,4390,4500,42.8833,27.8833
2010,Ruse,Byala,8890,4390,4500,43.4631,25.7214
2010,Ruse,Vetovo,4758,2339,2419,43.7,26.2667
2010,Ruse,Glodzhevo,3596,1773,1823,43.6833,26.5
2010,Ruse,Dve Mogili,4314,2125,2189,43.5,25.8833
2010,Ruse,Marten,3673,1813,1860,43.85,25.9333
2010,Ruse,Ruse,155818,75104,80714,43.8486,25.9534
2010,Ruse,Senovo,1550,761,789,43.6167,26.3167
2010,Ruse,Slivo pole,3179,1574,1605,43.85,26.2
2010,Ruse,Silistra,56830,27386,29444,44.1167,27.2667
2010,Ruse,Silistra,56830,27386,29444,44.1167,27.2667
2010,Ruse,Alfatar,1668,836,832,43.95,27.3
2010,Ruse,Glavinitsa,1891,921,970,43.9333,26.8333
2010,Ruse,Dulovo,6568,3173,3395,43.8333,27.1333
2010,Ruse,Silistra,37332,17899,19433,44.1167,27.2667
2010,Ruse,Silistra,37332,17899,19433,44.1167,27.2667
2010,Ruse,Tutrakan,9371,4557,4814,44.05,26.6167
2010,Sliven,Kermen,1859,919,940,42.6333,26.1333
2010,Sliven,Kotel,6066,2892,3174,42.8833,26.45
2010,Sliven,Nova Zagora,23325,11339,11986,42.4833,26.0167
2010,Sliven,Sliven,92478,44448,48030,42.6833,26.3167
2010,Sliven,Tvarditsa,5651,2865,2786,42.7167,26.0167
2010,Sliven,Shivachevo,3795,1901,1894,42.7,26.0667
2010,Smolyan,Devin,6996,3299,3697,41.7444,24.3978
2010,Smolyan,Dospat,2540,1247,1293,41.6436,24.1667
2010,Smolyan,Zlatograd,7077,3298,3779,41.3833,25.1
2010,Smolyan,Madan,6026,2997,3029,41.4833,24.9333
2010,Smolyan,Nedelino,4529,2162,2367,41.5167,25.1
2010,Smolyan,Rudozem,3499,1633,1866,41.4833,24.85
2010,Smolyan,Smolyan,31404,15132,16272,41.5739,24.7128
2010,Smolyan,Chepelare,5344,2601,2743,41.7269,24.6833
2010,Sofia (stolitsa),Bankya,10126,5002,5124,42.6983,23.1342
2010,Sofia (stolitsa),Buhovo,2952,1434,1518,42.7667,23.4667
2010,Sofia (stolitsa),Novi Iskar,13855,6788,7067,42.8022,23.3006
2010,Sofia (stolitsa),Sofia,1174515,557069,617446,42.6977,23.3219
2010,Sofia (oblast),Bozhurishte,5439,2612,2827,42.755,23.1897
2010,Sofia (oblast),Botevgrad,20444,9840,10604,42.9119,23.8106
2010,Sofia (oblast),Godech,4355,2153,2202,43.0122,23.0447
2010,Sofia (oblast),Dolna Banya,4665,2269,2396,42.3,23.7833
2010,Sofia (oblast),Dragoman,3332,1647,1685,42.9225,23.0464
2010,Sofia (oblast),Elin Pelin,6705,3224,3481,42.6667,23.6
2010,Sofia (oblast),Etropole,10750,5246,5504,42.8333,24.0
2010,Sofia (oblast),Zlatitsa,5090,2464,2626,42.7,24.1333
2010,Sofia (oblast),Ihtiman,13297,6559,6738,42.4333,23.8167
2010,Sofia (oblast),Koprivshtitsa,2377,1153,1224,42.6333,24.35
2010,Sofia (oblast),Kostenets,7018,3408,3610,42.3086,23.8578
2010,Sofia (oblast),Kostinbrod,11896,5787,6109,42.8136,23.2178
2010,Sofia (oblast),Momin prohod,1543,736,807,42.4,23.85
2010,Sofia (oblast),Pirdop,7651,3682,3969,42.7,24.1833
2010,Sofia (oblast),Pravets,4621,2354,2267,42.8986,23.9142
2010,Sofia (oblast),Samokov,26061,12501,13560,42.3378,23.5528
2010,Sofia (oblast),Svoge,8033,3920,4113,42.9597,23.3408
2010,Sofia (oblast),Slivnitsa,7333,3652,3681,42.8511,23.0356
2010,Stara Zagora,Gurkovo,2917,1443,1474,42.65,25.8167
2010,Stara Zagora,Galabovo,8425,4248,4177,42.1333,25.8667
2010,Stara Zagora,Kazanlak,48818,23232,25586,42.6167,25.4
2010,Stara Zagora,Kran,3316,1647,1669,42.6658,25.3738
2010,Stara Zagora,Maglizh,3398,1726,1672,42.6167,25.5667
2010,Stara Zagora,Nikolaevo,2864,1381,1483,42.6833,25.85
2010,Stara Zagora,Pavel Banya,2914,1369,1545,42.6167,25.2
2010,Stara Zagora,Radnevo,13207,6594,6613,42.3,25.9333
2010,Stara Zagora,Stara Zagora,139749,67400,72349,42.4258,25.6347
2010,Stara Zagora,Chirpan,16133,7823,8310,42.2,25.3333
2010,Stara Zagora,Shipka,1466,686,780,42.7167,25.3333
2010,Targovishte,Antonovo,1429,725,704,43.15,26.1667
2010,Targovishte,Omurtag,8612,4081,4531,43.1,26.4167
2010,Targovishte,Opaka,2817,1396,1421,43.45,26.1667
2010,Targovishte,Popovo,15286,7286,8000,43.35,26.2333
2010,Targovishte,Targovishte,37137,17693,19444,43.25,26.5833
2010,Haskovo,Dimitrovgrad,38785,18587,20198,42.0519,25.5897
2010,Haskovo,Ivaylovgrad,3704,1802,1902,41.5283,26.1256
2010,Haskovo,Lyubimets,7587,3760,3827,41.8333,26.0833
2010,Haskovo,Madzharovo,613,299,314,41.6292,25.8667
2010,Haskovo,Merichleri,1915,927,988,42.0,25.8
2010,Haskovo,Svilengrad,18005,8774,9231,41.7667,26.2
2010,Haskovo,Simeonovgrad,6941,3379,3562,42.0333,25.8333
2010,Haskovo,Topolovgrad,5542,2740,2802,42.0844,26.3386
2010,Haskovo,Harmanli,18360,8925,9435,41.9333,25.9
2010,Haskovo,Haskovo,76431,36307,40124,41.9333,25.5667
2010,Shumen,Veliki Preslav,8886,4394,4492,43.1667,26.8167
2010,Shumen,Varbitsa,3560,1738,1822,43.1667,26.5833
2010,Shumen,Kaolinovo,1492,736,756,43.3167,27.0167
2010,Shumen,Kaspichan,3175,1554,1621,43.3167,27.1667
2010,Shumen,Novi Pazar,12613,6021,6592,43.35,27.2
2010,Shumen,Pliska,1045,494,551,43.3667,27.1167
2010,Shumen,Smyadovo,3986,1965,2021,43.0333,27.05
2010,Shumen,Shumen,86290,41020,45270,43.2714,26.9361
2010,Yambol,Bolyarovo,1264,623,641,42.1,26.8333
2010,Yambol,Elhovo,10367,5033,5334,42.1667,26.5667
2010,Yambol,Straldzha,5977,2994,2983,42.6,26.6833
2010,Yambol,Yambol,75742,36541,39201,42.4833,26.5
2011,Blagoevgrad,Bansko,8951,4370,4581,41.8383,23.488
2011,Blagoevgrad,Belitsa,3327,1592,1735,41.9494,23.5725
2011,Blagoevgrad,Blagoevgrad,70656,33674,36982,42.0167,23.1
2011,Blagoevgrad,Gotse Delchev,19091,9225,9866,41.5667,23.7333
2011,Blagoevgrad,Dobrinishte,2808,1365,1443,41.825,23.5594
2011,Blagoevgrad,Kresna,3552,1799,1753,41.73,23.1569
2011,Blagoevgrad,Melnik,216,104,112,41.5231,23.3925
2011,Blagoevgrad,Petrich,28784,13927,14857,41.3981,23.2072
2011,Blagoevgrad,Razlog,11900,5791,6109,41.8864,23.4678
2011,Blagoevgrad,Sandanski,26206,12740,13466,41.5667,23.2833
2011,Blagoevgrad,Simitli,6696,3365,3331,41.8936,23.1069
2011,Blagoevgrad,Hadzhidimovo,2695,1385,1310,41.5167,23.8667
2011,Blagoevgrad,Yakoruda,5737,2775,2962,42.02,23.6833
2011,Burgas,Aytos,19904,9670,10234,42.7,27.25
2011,Burgas,Aheloy,2426,1226,1200,42.6483,27.6494
2011,Burgas,Ahtopol,1295,639,656,42.1,27.95
2011,Burgas,Burgas,199484,96654,102830,42.4975,27.47
2011,Burgas,Bulgarovo,1681,853,828,42.65,27.3333
2011,Burgas,Kableshkovo,2895,1436,1459,42.6167,27.5667
2011,Burgas,Kameno,4312,2108,2204,42.5667,27.3667
2011,Burgas,Karnobat,18456,8963,9493,42.65,26.9833
2011,Burgas,Kiten,950,482,468,42.2344,27.7711
2011,Burgas,Malko Tarnovo,2437,1188,1249,41.9833,27.5333
2011,Burgas,Nesebar,10531,5132,5399,42.66,27.72
2011,Burgas,Obzor,2155,1084,1071,42.8167,27.8833
2011,Burgas,Pomorie,13525,6524,7001,42.55,27.65
2011,Burgas,Primorsko,2989,1474,1515,42.2667,27.75
2011,Burgas,Sveti Vlas,2902,1511,1391,42.7167,27.7667
2011,Burgas,Sozopol,4285,2101,2184,42.4167,27.7
2011,Burgas,Sredets,9032,4439,4593,42.3483,27.1933
2011,Burgas,Sungurlare,3185,1579,1606,42.7667,26.7833
2011,Burgas,Tsarevo,6065,2979,3086,42.17,27.85
2011,Burgas,Chernomorets,2062,1040,1022,42.45,27.64
2011,Varna,Aksakovo,7839,3859,3980,43.2592,27.8211
2011,Varna,Beloslav,7782,3895,3887,43.19,27.7
2011,Varna,Byala,2011,1029,982,42.8833,27.8833
2011,Varna,Byala,2011,1029,982,43.4631,25.7214
2011,Varna,Varna,334781,162589,172192,43.2167,27.9167
2011,Varna,Valchi Dol,3169,1538,1631,43.4,27.5333
2011,Varna,Devnya,8031,3965,4066,43.2222,27.57
2011,Varna,Dolni Chiflik,6638,3290,3348,42.9833,27.7333
2011,Varna,Dalgopol,4822,2417,2405,43.05,27.35
2011,Varna,Ignatievo,4006,1950,2056,43.3,27.7
2011,Varna,Provadia,13049,6423,6626,43.1833,27.4333
2011,Varna,Suvorovo,4567,2280,2287,43.33,27.6
2011,Veliko Tarnovo,Byala Cherkva,1868,891,977,43.15,25.3
2011,Veliko Tarnovo,Veliko Tarnovo,68735,32666,36069,43.0833,25.65
2011,Veliko Tarnovo,Gorna Oryahovitsa,31437,15175,16262,43.1278,25.7019
2011,Veliko Tarnovo,Debelets,3986,1948,2038,43.0333,25.6167
2011,Veliko Tarnovo,Dolna Oryahovitsa,2932,1448,1484,43.1167,25.7833
2011,Veliko Tarnovo,Elena,5532,2655,2877,42.9333,25.8833
2011,Veliko Tarnovo,Zlataritsa,2163,1071,1092,43.05,25.9
2011,Veliko Tarnovo,Kilifarevo,2234,1082,1152,42.9833,25.6333
2011,Veliko Tarnovo,Lyaskovets,8179,3924,4255,43.1111,25.7261
2011,Veliko Tarnovo,Pavlikeni,10488,5128,5360,43.2428,25.3219
2011,Veliko Tarnovo,Polski Trambesh,4298,2161,2137,43.3667,25.65
2011,Veliko Tarnovo,Svishtov,29846,14117,15729,43.6239,25.3531
2011,Veliko Tarnovo,Strazhitsa,4394,2186,2208,43.2333,25.9667
2011,Veliko Tarnovo,Suhindol,1800,870,930,43.1833,25.2
2011,Vidin,Belogradchik,5140,2549,2591,43.6278,22.6833
2011,Vidin,Bregovo,2497,1197,1300,44.15,22.65
2011,Vidin,Vidin,47382,23099,24283,43.99,22.8725
2011,Vidin,Gramada,1433,713,720,43.8742,22.6783
2011,Vidin,Dimovo,1193,605,588,43.7417,22.7283
2011,Vidin,Dunavtsi,2251,1113,1138,44.0,22.8667
2011,Vidin,Kula,3158,1533,1625,43.89,22.5217
2011,Vratsa,Byala Slatina,11050,5371,5679,43.4667,23.9333
2011,Vratsa,Vratsa,59700,29276,30424,43.21,23.5625
2011,Vratsa,Kozloduy,12856,6395,6461,43.7833,23.7333
2011,Vratsa,Krivodol,3084,1523,1561,43.3683,23.4936
2011,Vratsa,Mezdra,10789,5207,5582,43.15,23.7
2011,Vratsa,Mizia,3214,1595,1619,43.6867,23.8458
2011,Vratsa,Oryahovo,5006,2449,2557,43.7358,23.9619
2011,Vratsa,Roman,2807,1391,1416,43.1369,24.125
2011,Gabrovo,Gabrovo,58367,28143,30224,42.8747,25.3186
2011,Gabrovo,Dryanovo,7326,3516,3810,42.9747,25.4781
2011,Gabrovo,Plachkovtsi,1771,885,886,42.8333,25.4333
2011,Gabrovo,Sevlievo,22516,10925,11591,43.0275,25.1125
2011,Gabrovo,Tryavna,9313,4452,4861,42.8672,25.5008
2011,Dobrich,Balchik,11593,5772,5821,43.4072,28.1672
2011,Dobrich,General Toshevo,6840,3377,3463,43.7,28.0333
2011,Dobrich,Dobrich,90375,43694,46681,43.5667,27.8333
2011,Dobrich,Kavarna,11481,5585,5896,43.4358,28.3386
2011,Dobrich,Tervel,5989,2941,3048,43.7472,27.41
2011,Dobrich,Shabla,3390,1686,1704,43.535,28.5339
2011,Kardzhali,Ardino,3457,1716,1741,41.5833,25.1333
2011,Kardzhali,Dzhebel,3099,1547,1552,41.4933,25.305
2011,Kardzhali,Krumovgrad,5019,2433,2586,41.4667,25.65
2011,Kardzhali,Kardzhali,43785,21053,22732,41.65,25.3667
2011,Kardzhali,Momchilgrad,7798,3870,3928,41.5258,25.4061
2011,Kyustendil,Bobovdol,5703,3077,2626,42.3522,23.0333
2011,Kyustendil,Boboshevo,1224,564,660,42.1461,23.0708
2011,Kyustendil,Dupnitsa,33205,16003,17202,42.2667,23.1167
2011,Kyustendil,Kocherinovo,2332,1111,1221,42.1167,23.0833
2011,Kyustendil,Kyustendil,44111,21253,22858,42.2833,22.6833
2011,Kyustendil,Rila,2351,1140,1211,42.13,23.3869
2011,Kyustendil,Sapareva Banya,3785,1881,1904,42.2889,23.2672
2011,Lovech,Apriltsi,2969,1442,1527,42.85,24.9167
2011,Lovech,Letnitsa,2653,1315,1338,43.2558,25.0639
2011,Lovech,Lovech,36200,17781,18419,43.1333,24.7167
2011,Lovech,Lukovit,8901,4362,4539,43.2,24.1667
2011,Lovech,Teteven,9686,4770,4916,42.9167,24.2667
2011,Lovech,Troyan,21003,10204,10799,42.89,24.7133
2011,Lovech,Ugarchin,2509,1215,1294,43.1,24.3167
2011,Lovech,Yablanitsa,2854,1435,1419,43.05,24.1
2011,Montana,Berkovitsa,13279,6480,6799,43.2392,23.1272
2011,Montana,Boychinovtsi,1524,771,753,43.4683,23.3044
2011,Montana,Brusartsi,1171,576,595,43.7,23.05
2011,Montana,Valchedram,3594,1742,1852,43.715,23.45
2011,Montana,Varshets,6179,3035,3144,43.1981,23.2875
2011,Montana,Lom,22306,10825,11481,43.8139,23.2369
2011,Montana,Montana,43375,21367,22008,43.4125,23.225
2011,Montana,Chiprovtsi,1839,905,934,43.3844,22.8822
2011,Pazardzhik,Batak,3259,1627,1632,41.9442,24.2181
2011,Pazardzhik,Belovo,3834,1864,1970,42.2122,24.015
2011,Pazardzhik,Bratsigovo,4084,2031,2053,42.0128,24.3742
2011,Pazardzhik,Velingrad,22500,10734,11766,42.0278,23.9908
2011,Pazardzhik,Vetren,3188,1591,1597,42.245,24.0894
2011,Pazardzhik,Kostandovo,4154,2086,2068,42.0656,24.0517
2011,Pazardzhik,Pazardzhik,71437,34783,36654,42.1922,24.3331
2011,Pazardzhik,Panagyurishte,17467,8627,8840,42.5,24.1833
2011,Pazardzhik,Peshtera,16719,8187,8532,42.0347,24.2994
2011,Pazardzhik,Rakitovo,8119,4031,4088,41.9878,24.0861
2011,Pazardzhik,Septemvri,7863,3894,3969,42.2167,24.1
2011,Pazardzhik,Strelcha,4021,1947,2074,42.5,24.3167
2011,Pazardzhik,Sarnitsa,3571,1808,1763,41.7858,24.015
2011,Pernik,Batanovtsi,2277,1122,1155,42.5539,23.0325
2011,Pernik,Breznik,4099,1994,2105,42.7394,22.9078
2011,Pernik,Zemen,1656,822,834,42.48,22.7489
2011,Pernik,Pernik,79169,38347,40822,42.6078,23.0375
2011,Pernik,Radomir,14317,7072,7245,42.5453,22.9775
2011,Pernik,Tran,2427,1220,1207,42.8342,22.6519
2011,Pleven,Belene,8402,4603,3799,43.6511,25.1133
2011,Pleven,Gulyantsi,3158,1546,1612,43.6486,24.7125
2011,Pleven,Dolna Mitropolia,3042,1465,1577,43.4667,24.5333
2011,Pleven,Dolni Dabnik,4161,2029,2132,43.4167,24.4333
2011,Pleven,Iskar,3162,1588,1574,43.4608,24.2686
2011,Pleven,Knezha,10367,5117,5250,43.5,24.0833
2011,Pleven,Koynare,3686,1824,1862,43.3667,24.0833
2011,Pleven,Levski,9804,4770,5034,43.4333,25.1333
2011,Pleven,Nikopol,3171,1557,1614,43.7081,24.8983
2011,Pleven,Pleven,105673,51066,54607,43.4167,24.6167
2011,Pleven,Pordim,2003,992,1011,43.4167,24.9167
2011,Pleven,Slavyanovo,3836,1895,1941,43.3167,24.8667
2011,Pleven,Trastenik,4324,2142,2182,43.4833,24.55
2011,Pleven,Cherven Bryag,12639,6299,6340,43.2667,24.1
2011,Plovdiv,Asenovgrad,50590,24469,26121,42.0167,24.8667
2011,Plovdiv,Banya,3451,1630,1821,42.5,24.8333
2011,Plovdiv,Brezovo,1882,929,953,42.4833,25.0833
2011,Plovdiv,Kalofer,3055,1435,1620,42.6178,24.98
2011,Plovdiv,Karlovo,22931,11018,11913,42.6333,24.8
2011,Plovdiv,Klisura,1086,516,570,42.7,24.45
2011,Plovdiv,Krichim,8370,4121,4249,42.0333,24.4667
2011,Plovdiv,Kuklen,5854,2878,2976,42.0333,24.7833
2011,Plovdiv,Laki,2104,1083,1021,41.8167,24.8333
2011,Plovdiv,Perushtitsa,5029,2459,2570,42.0333,24.55
2011,Plovdiv,Plovdiv,338184,161336,176848,42.15,24.75
2011,Plovdiv,Parvomay,13219,6348,6871,42.1,25.2167
2011,Plovdiv,Rakovski,15099,7362,7737,42.2833,24.9333
2011,Plovdiv,Sadovo,2571,1292,1279,42.1333,24.8667
2011,Plovdiv,Sopot,8700,4231,4469,42.6667,24.75
2011,Plovdiv,Stamboliyski,11495,5570,5925,42.1333,24.5333
2011,Plovdiv,Saedinenie,5591,2749,2842,42.25,24.6
2011,Plovdiv,Hisarya,7066,3372,3694,42.5,24.7
2011,Razgrad,Zavet,3011,1498,1513,43.7333,26.5833
2011,Razgrad,Isperih,8864,4320,4544,43.7167,26.8333
2011,Razgrad,Kubrat,7268,3498,3770,43.8,26.5
2011,Razgrad,Loznitsa,2222,1100,1122,43.4333,26.6167
2011,Razgrad,Razgrad,33416,15841,17575,43.5333,26.5167
2011,Razgrad,Tsar Kaloyan,3716,1818,1898,43.6333,26.2333
2011,Ruse,Borovo,2023,1011,1012,43.5667,25.8167
2011,Ruse,Byala,8342,4135,4207,42.8833,27.8833
2011,Ruse,Byala,8342,4135,4207,43.4631,25.7214
2011,Ruse,Vetovo,4412,2208,2204,43.7,26.2667
2011,Ruse,Glodzhevo,3464,1720,1744,43.6833,26.5
2011,Ruse,Dve Mogili,4166,2061,2105,43.5,25.8833
2011,Ruse,Marten,3632,1819,1813,43.85,25.9333
2011,Ruse,Ruse,149134,72118,77016,43.8486,25.9534
2011,Ruse,Senovo,1408,690,718,43.6167,26.3167
2011,Ruse,Slivo pole,2984,1484,1500,43.85,26.2
2011,Ruse,Silistra,53496,26092,27404,44.1167,27.2667
2011,Ruse,Silistra,53496,26092,27404,44.1167,27.2667
2011,Ruse,Alfatar,1625,818,807,43.95,27.3
2011,Ruse,Glavinitsa,1545,743,802,43.9333,26.8333
2011,Ruse,Dulovo,6528,3255,3273,43.8333,27.1333
2011,Ruse,Silistra,35230,17065,18165,44.1167,27.2667
2011,Ruse,Silistra,35230,17065,18165,44.1167,27.2667
2011,Ruse,Tutrakan,8568,4211,4357,44.05,26.6167
2011,Sliven,Kermen,1752,870,882,42.6333,26.1333
2011,Sliven,Kotel,5711,2734,2977,42.8833,26.45
2011,Sliven,Nova Zagora,22200,10815,11385,42.4833,26.0167
2011,Sliven,Sliven,91042,43896,47146,42.6833,26.3167
2011,Sliven,Tvarditsa,5669,2899,2770,42.7167,26.0167
2011,Sliven,Shivachevo,3660,1815,1845,42.7,26.0667
2011,Smolyan,Devin,6929,3324,3605,41.7444,24.3978
2011,Smolyan,Dospat,2390,1163,1227,41.6436,24.1667
2011,Smolyan,Zlatograd,7116,3407,3709,41.3833,25.1
2011,Smolyan,Madan,5791,2886,2905,41.4833,24.9333
2011,Smolyan,Nedelino,4483,2197,2286,41.5167,25.1
2011,Smolyan,Rudozem,3735,1828,1907,41.4833,24.85
2011,Smolyan,Smolyan,30313,14608,15705,41.5739,24.7128
2011,Smolyan,Chepelare,5303,2590,2713,41.7269,24.6833
2011,Sofia (stolitsa),Bankya,11102,5414,5688,42.6983,23.1342
2011,Sofia (stolitsa),Buhovo,2753,1363,1390,42.7667,23.4667
2011,Sofia (stolitsa),Novi Iskar,14654,7213,7441,42.8022,23.3006
2011,Sofia (stolitsa),Sofia,1208097,574567,633530,42.6977,23.3219
2011,Sofia (oblast),Bozhurishte,5618,2709,2909,42.755,23.1897
2011,Sofia (oblast),Botevgrad,20242,9885,10357,42.9119,23.8106
2011,Sofia (oblast),Godech,4383,2177,2206,43.0122,23.0447
2011,Sofia (oblast),Dolna Banya,4511,2219,2292,42.3,23.7833
2011,Sofia (oblast),Dragoman,3371,1665,1706,42.9225,23.0464
2011,Sofia (oblast),Elin Pelin,6811,3325,3486,42.6667,23.6
2011,Sofia (oblast),Etropole,10209,5076,5133,42.8333,24.0
2011,Sofia (oblast),Zlatitsa,5046,2446,2600,42.7,24.1333
2011,Sofia (oblast),Ihtiman,13074,6488,6586,42.4333,23.8167
2011,Sofia (oblast),Koprivshtitsa,2370,1157,1213,42.6333,24.35
2011,Sofia (oblast),Kostenets,6737,3291,3446,42.3086,23.8578
2011,Sofia (oblast),Kostinbrod,12096,5908,6188,42.8136,23.2178
2011,Sofia (oblast),Momin prohod,1604,764,840,42.4,23.85
2011,Sofia (oblast),Pirdop,7426,3638,3788,42.7,24.1833
2011,Sofia (oblast),Pravets,3782,1900,1882,42.8986,23.9142
2011,Sofia (oblast),Samokov,26529,12873,13656,42.3378,23.5528
2011,Sofia (oblast),Svoge,8192,4072,4120,42.9597,23.3408
2011,Sofia (oblast),Slivnitsa,7594,3788,3806,42.8511,23.0356
2011,Stara Zagora,Gurkovo,2768,1399,1369,42.65,25.8167
2011,Stara Zagora,Galabovo,8187,4123,4064,42.1333,25.8667
2011,Stara Zagora,Kazanlak,46990,22600,24390,42.6167,25.4
2011,Stara Zagora,Kran,3316,1647,1669,42.6658,25.3738
2011,Stara Zagora,Maglizh,3256,1621,1635,42.6167,25.5667
2011,Stara Zagora,Nikolaevo,2670,1306,1364,42.6833,25.85
2011,Stara Zagora,Pavel Banya,2750,1281,1469,42.6167,25.2
2011,Stara Zagora,Radnevo,12731,6337,6394,42.3,25.9333
2011,Stara Zagora,Stara Zagora,137416,66706,70710,42.4258,25.6347
2011,Stara Zagora,Chirpan,15395,7543,7852,42.2,25.3333
2011,Stara Zagora,Shipka,1310,632,678,42.7167,25.3333
2011,Targovishte,Antonovo,1571,789,782,43.15,26.1667
2011,Targovishte,Omurtag,7628,3599,4029,43.1,26.4167
2011,Targovishte,Opaka,2786,1385,1401,43.45,26.1667
2011,Targovishte,Popovo,15453,7442,8011,43.35,26.2333
2011,Targovishte,Targovishte,37341,18012,19329,43.25,26.5833
2011,Haskovo,Dimitrovgrad,38217,18634,19583,42.0519,25.5897
2011,Haskovo,Ivaylovgrad,3692,1833,1859,41.5283,26.1256
2011,Haskovo,Lyubimets,7581,3781,3800,41.8333,26.0833
2011,Haskovo,Madzharovo,644,330,314,41.6292,25.8667
2011,Haskovo,Merichleri,1661,815,846,42.0,25.8
2011,Haskovo,Svilengrad,18065,8869,9196,41.7667,26.2
2011,Haskovo,Simeonovgrad,6699,3292,3407,42.0333,25.8333
2011,Haskovo,Topolovgrad,5470,2734,2736,42.0844,26.3386
2011,Haskovo,Harmanli,18429,9018,9411,41.9333,25.9
2011,Haskovo,Haskovo,75641,36228,39413,41.9333,25.5667
2011,Shumen,Veliki Preslav,7655,3730,3925,43.1667,26.8167
2011,Shumen,Varbitsa,3327,1632,1695,43.1667,26.5833
2011,Shumen,Kaolinovo,1462,745,717,43.3167,27.0167
2011,Shumen,Kaspichan,3084,1515,1569,43.3167,27.1667
2011,Shumen,Novi Pazar,11932,5801,6131,43.35,27.2
2011,Shumen,Pliska,898,437,461,43.3667,27.1167
2011,Shumen,Smyadovo,3799,1888,1911,43.0333,27.05
2011,Shumen,Shumen,80511,38547,41964,43.2714,26.9361
2011,Yambol,Bolyarovo,1220,587,633,42.1,26.8333
2011,Yambol,Elhovo,10445,5112,5333,42.1667,26.5667
2011,Yambol,Straldzha,5704,2847,2857,42.6,26.6833
2011,Yambol,Yambol,73268,35706,37562,42.4833,26.5
2012,Blagoevgrad,Bansko,8925,4356,4569,41.8383,23.488
2012,Blagoevgrad,Belitsa,3281,1570,1711,41.9494,23.5725
2012,Blagoevgrad,Blagoevgrad,70562,33671,36891,42.0167,23.1
2012,Blagoevgrad,Gotse Delchev,18994,9186,9808,41.5667,23.7333
2012,Blagoevgrad,Dobrinishte,2755,1337,1418,41.825,23.5594
2012,Blagoevgrad,Kresna,3502,1765,1737,41.73,23.1569
2012,Blagoevgrad,Melnik,209,101,108,41.5231,23.3925
2012,Blagoevgrad,Petrich,28890,14057,14833,41.3981,23.2072
2012,Blagoevgrad,Razlog,11824,5757,6067,41.8864,23.4678
2012,Blagoevgrad,Sandanski,26085,12707,13378,41.5667,23.2833
2012,Blagoevgrad,Simitli,6654,3347,3307,41.8936,23.1069
2012,Blagoevgrad,Hadzhidimovo,2647,1356,1291,41.5167,23.8667
2012,Blagoevgrad,Yakoruda,5659,2733,2926,42.02,23.6833
2012,Burgas,Aytos,19827,9628,10199,42.7,27.25
2012,Burgas,Aheloy,2404,1214,1190,42.6483,27.6494
2012,Burgas,Ahtopol,1289,635,654,42.1,27.95
2012,Burgas,Burgas,199083,96270,102813,42.4975,27.47
2012,Burgas,Bulgarovo,1662,834,828,42.65,27.3333
2012,Burgas,Kableshkovo,2905,1432,1473,42.6167,27.5667
2012,Burgas,Kameno,4316,2122,2194,42.5667,27.3667
2012,Burgas,Karnobat,18212,8830,9382,42.65,26.9833
2012,Burgas,Kiten,945,481,464,42.2344,27.7711
2012,Burgas,Malko Tarnovo,2379,1175,1204,41.9833,27.5333
2012,Burgas,Nesebar,10803,5260,5543,42.66,27.72
2012,Burgas,Obzor,2144,1070,1074,42.8167,27.8833
2012,Burgas,Pomorie,13564,6541,7023,42.55,27.65
2012,Burgas,Primorsko,2974,1482,1492,42.2667,27.75
2012,Burgas,Sveti Vlas,3003,1559,1444,42.7167,27.7667
2012,Burgas,Sozopol,4290,2092,2198,42.4167,27.7
2012,Burgas,Sredets,8974,4404,4570,42.3483,27.1933
2012,Burgas,Sungurlare,3163,1560,1603,42.7667,26.7833
2012,Burgas,Tsarevo,6012,2943,3069,42.17,27.85
2012,Burgas,Chernomorets,2046,1021,1025,42.45,27.64
2012,Varna,Aksakovo,7868,3877,3991,43.2592,27.8211
2012,Varna,Beloslav,7741,3880,3861,43.19,27.7
2012,Varna,Byala,1994,1008,986,42.8833,27.8833
2012,Varna,Byala,1994,1008,986,43.4631,25.7214
2012,Varna,Varna,334744,162598,172146,43.2167,27.9167
2012,Varna,Valchi Dol,3149,1526,1623,43.4,27.5333
2012,Varna,Devnya,8033,3981,4052,43.2222,27.57
2012,Varna,Dolni Chiflik,6600,3261,3339,42.9833,27.7333
2012,Varna,Dalgopol,4758,2382,2376,43.05,27.35
2012,Varna,Ignatievo,4026,1959,2067,43.3,27.7
2012,Varna,Provadia,12932,6369,6563,43.1833,27.4333
2012,Varna,Suvorovo,4533,2258,2275,43.33,27.6
2012,Veliko Tarnovo,Byala Cherkva,1820,874,946,43.15,25.3
2012,Veliko Tarnovo,Veliko Tarnovo,68871,32721,36150,43.0833,25.65
2012,Veliko Tarnovo,Gorna Oryahovitsa,31094,15004,16090,43.1278,25.7019
2012,Veliko Tarnovo,Debelets,3992,1942,2050,43.0333,25.6167
2012,Veliko Tarnovo,Dolna Oryahovitsa,2879,1409,1470,43.1167,25.7833
2012,Veliko Tarnovo,Elena,5423,2607,2816,42.9333,25.8833
2012,Veliko Tarnovo,Zlataritsa,2136,1063,1073,43.05,25.9
2012,Veliko Tarnovo,Kilifarevo,2219,1076,1143,42.9833,25.6333
2012,Veliko Tarnovo,Lyaskovets,8097,3878,4219,43.1111,25.7261
2012,Veliko Tarnovo,Pavlikeni,10376,5068,5308,43.2428,25.3219
2012,Veliko Tarnovo,Polski Trambesh,4245,2137,2108,43.3667,25.65
2012,Veliko Tarnovo,Svishtov,29373,13956,15417,43.6239,25.3531
2012,Veliko Tarnovo,Strazhitsa,4375,2167,2208,43.2333,25.9667
2012,Veliko Tarnovo,Suhindol,1769,861,908,43.1833,25.2
2012,Vidin,Belogradchik,5111,2538,2573,43.6278,22.6833
2012,Vidin,Bregovo,2474,1186,1288,44.15,22.65
2012,Vidin,Vidin,46877,22828,24049,43.99,22.8725
2012,Vidin,Gramada,1400,691,709,43.8742,22.6783
2012,Vidin,Dimovo,1175,595,580,43.7417,22.7283
2012,Vidin,Dunavtsi,2196,1086,1110,44.0,22.8667
2012,Vidin,Kula,3097,1497,1600,43.89,22.5217
2012,Vratsa,Byala Slatina,10934,5314,5620,43.4667,23.9333
2012,Vratsa,Vratsa,58856,28769,30087,43.21,23.5625
2012,Vratsa,Kozloduy,12775,6343,6432,43.7833,23.7333
2012,Vratsa,Krivodol,3024,1497,1527,43.3683,23.4936
2012,Vratsa,Mezdra,10624,5122,5502,43.15,23.7
2012,Vratsa,Mizia,3180,1578,1602,43.6867,23.8458
2012,Vratsa,Oryahovo,4929,2412,2517,43.7358,23.9619
2012,Vratsa,Roman,2773,1374,1399,43.1369,24.125
2012,Gabrovo,Gabrovo,57840,27959,29881,42.8747,25.3186
2012,Gabrovo,Dryanovo,7238,3482,3756,42.9747,25.4781
2012,Gabrovo,Plachkovtsi,1751,874,877,42.8333,25.4333
2012,Gabrovo,Sevlievo,22300,10826,11474,43.0275,25.1125
2012,Gabrovo,Tryavna,9202,4406,4796,42.8672,25.5008
2012,Dobrich,Balchik,11579,5757,5822,43.4072,28.1672
2012,Dobrich,General Toshevo,6759,3343,3416,43.7,28.0333
2012,Dobrich,Dobrich,89627,43264,46363,43.5667,27.8333
2012,Dobrich,Kavarna,11432,5567,5865,43.4358,28.3386
2012,Dobrich,Tervel,5965,2938,3027,43.7472,27.41
2012,Dobrich,Shabla,3359,1657,1702,43.535,28.5339
2012,Kardzhali,Ardino,3455,1716,1739,41.5833,25.1333
2012,Kardzhali,Dzhebel,3116,1546,1570,41.4933,25.305
2012,Kardzhali,Krumovgrad,4947,2391,2556,41.4667,25.65
2012,Kardzhali,Kardzhali,43681,20986,22695,41.65,25.3667
2012,Kardzhali,Momchilgrad,7743,3840,3903,41.5258,25.4061
2012,Kyustendil,Bobovdol,5653,3064,2589,42.3522,23.0333
2012,Kyustendil,Boboshevo,1182,546,636,42.1461,23.0708
2012,Kyustendil,Dupnitsa,32885,15809,17076,42.2667,23.1167
2012,Kyustendil,Kocherinovo,2295,1092,1203,42.1167,23.0833
2012,Kyustendil,Kyustendil,43605,20992,22613,42.2833,22.6833
2012,Kyustendil,Rila,2320,1124,1196,42.13,23.3869
2012,Kyustendil,Sapareva Banya,3766,1877,1889,42.2889,23.2672
2012,Lovech,Apriltsi,2915,1417,1498,42.85,24.9167
2012,Lovech,Letnitsa,2630,1306,1324,43.2558,25.0639
2012,Lovech,Lovech,35837,17593,18244,43.1333,24.7167
2012,Lovech,Lukovit,8853,4338,4515,43.2,24.1667
2012,Lovech,Teteven,9563,4701,4862,42.9167,24.2667
2012,Lovech,Troyan,20827,10096,10731,42.89,24.7133
2012,Lovech,Ugarchin,2513,1228,1285,43.1,24.3167
2012,Lovech,Yablanitsa,2824,1421,1403,43.05,24.1
2012,Montana,Berkovitsa,13156,6427,6729,43.2392,23.1272
2012,Montana,Boychinovtsi,1470,750,720,43.4683,23.3044
2012,Montana,Brusartsi,1123,549,574,43.7,23.05
2012,Montana,Valchedram,3523,1712,1811,43.715,23.45
2012,Montana,Varshets,6125,3009,3116,43.1981,23.2875
2012,Montana,Lom,22059,10726,11333,43.8139,23.2369
2012,Montana,Montana,42909,21105,21804,43.4125,23.225
2012,Montana,Chiprovtsi,1801,891,910,43.3844,22.8822
2012,Pazardzhik,Batak,3182,1594,1588,41.9442,24.2181
2012,Pazardzhik,Belovo,3818,1853,1965,42.2122,24.015
2012,Pazardzhik,Bratsigovo,4061,2014,2047,42.0128,24.3742
2012,Pazardzhik,Velingrad,22320,10654,11666,42.0278,23.9908
2012,Pazardzhik,Vetren,3145,1561,1584,42.245,24.0894
2012,Pazardzhik,Kostandovo,4133,2069,2064,42.0656,24.0517
2012,Pazardzhik,Pazardzhik,71195,34602,36593,42.1922,24.3331
2012,Pazardzhik,Panagyurishte,17307,8549,8758,42.5,24.1833
2012,Pazardzhik,Peshtera,16678,8174,8504,42.0347,24.2994
2012,Pazardzhik,Rakitovo,8123,4026,4097,41.9878,24.0861
2012,Pazardzhik,Septemvri,7805,3858,3947,42.2167,24.1
2012,Pazardzhik,Strelcha,4004,1944,2060,42.5,24.3167
2012,Pazardzhik,Sarnitsa,3559,1802,1757,41.7858,24.015
2012,Pernik,Batanovtsi,2242,1110,1132,42.5539,23.0325
2012,Pernik,Breznik,4081,1991,2090,42.7394,22.9078
2012,Pernik,Zemen,1626,810,816,42.48,22.7489
2012,Pernik,Pernik,78371,37924,40447,42.6078,23.0375
2012,Pernik,Radomir,14153,7001,7152,42.5453,22.9775
2012,Pernik,Tran,2421,1212,1209,42.8342,22.6519
2012,Pleven,Belene,8175,4470,3705,43.6511,25.1133
2012,Pleven,Gulyantsi,3122,1531,1591,43.6486,24.7125
2012,Pleven,Dolna Mitropolia,3003,1452,1551,43.4667,24.5333
2012,Pleven,Dolni Dabnik,4115,2000,2115,43.4167,24.4333
2012,Pleven,Iskar,3110,1555,1555,43.4608,24.2686
2012,Pleven,Knezha,10244,5056,5188,43.5,24.0833
2012,Pleven,Koynare,3611,1792,1819,43.3667,24.0833
2012,Pleven,Levski,9707,4727,4980,43.4333,25.1333
2012,Pleven,Nikopol,3151,1549,1602,43.7081,24.8983
2012,Pleven,Pleven,104416,50374,54042,43.4167,24.6167
2012,Pleven,Pordim,1978,980,998,43.4167,24.9167
2012,Pleven,Slavyanovo,3781,1860,1921,43.3167,24.8667
2012,Pleven,Trastenik,4253,2089,2164,43.4833,24.55
2012,Pleven,Cherven Bryag,12469,6208,6261,43.2667,24.1
2012,Plovdiv,Asenovgrad,50307,24315,25992,42.0167,24.8667
2012,Plovdiv,Banya,3403,1599,1804,42.5,24.8333
2012,Plovdiv,Brezovo,1875,924,951,42.4833,25.0833
2012,Plovdiv,Kalofer,3008,1411,1597,42.6178,24.98
2012,Plovdiv,Karlovo,22848,11019,11829,42.6333,24.8
2012,Plovdiv,Klisura,1050,500,550,42.7,24.45
2012,Plovdiv,Krichim,8317,4098,4219,42.0333,24.4667
2012,Plovdiv,Kuklen,5855,2859,2996,42.0333,24.7833
2012,Plovdiv,Laki,2089,1065,1024,41.8167,24.8333
2012,Plovdiv,Perushtitsa,4986,2428,2558,42.0333,24.55
2012,Plovdiv,Plovdiv,339129,161710,177419,42.15,24.75
2012,Plovdiv,Parvomay,13101,6274,6827,42.1,25.2167
2012,Plovdiv,Rakovski,15059,7330,7729,42.2833,24.9333
2012,Plovdiv,Sadovo,2568,1286,1282,42.1333,24.8667
2012,Plovdiv,Sopot,8627,4191,4436,42.6667,24.75
2012,Plovdiv,Stamboliyski,11399,5519,5880,42.1333,24.5333
2012,Plovdiv,Saedinenie,5546,2730,2816,42.25,24.6
2012,Plovdiv,Hisarya,6958,3321,3637,42.5,24.7
2012,Razgrad,Zavet,2984,1499,1485,43.7333,26.5833
2012,Razgrad,Isperih,8720,4244,4476,43.7167,26.8333
2012,Razgrad,Kubrat,7181,3447,3734,43.8,26.5
2012,Razgrad,Loznitsa,2207,1092,1115,43.4333,26.6167
2012,Razgrad,Razgrad,33005,15641,17364,43.5333,26.5167
2012,Razgrad,Tsar Kaloyan,3678,1806,1872,43.6333,26.2333
2012,Ruse,Borovo,1996,996,1000,43.5667,25.8167
2012,Ruse,Byala,8218,4063,4155,42.8833,27.8833
2012,Ruse,Byala,8218,4063,4155,43.4631,25.7214
2012,Ruse,Vetovo,4358,2193,2165,43.7,26.2667
2012,Ruse,Glodzhevo,3419,1703,1716,43.6833,26.5
2012,Ruse,Dve Mogili,4106,2028,2078,43.5,25.8833
2012,Ruse,Marten,3600,1813,1787,43.85,25.9333
2012,Ruse,Ruse,148350,71801,76549,43.8486,25.9534
2012,Ruse,Senovo,1387,674,713,43.6167,26.3167
2012,Ruse,Slivo pole,2962,1477,1485,43.85,26.2
2012,Ruse,Silistra,52838,25741,27097,44.1167,27.2667
2012,Ruse,Silistra,52838,25741,27097,44.1167,27.2667
2012,Ruse,Alfatar,1596,804,792,43.95,27.3
2012,Ruse,Glavinitsa,1536,738,798,43.9333,26.8333
2012,Ruse,Dulovo,6509,3241,3268,43.8333,27.1333
2012,Ruse,Silistra,34728,16783,17945,44.1167,27.2667
2012,Ruse,Silistra,34728,16783,17945,44.1167,27.2667
2012,Ruse,Tutrakan,8469,4175,4294,44.05,26.6167
2012,Sliven,Kermen,1705,857,848,42.6333,26.1333
2012,Sliven,Kotel,5666,2707,2959,42.8833,26.45
2012,Sliven,Nova Zagora,22104,10765,11339,42.4833,26.0167
2012,Sliven,Sliven,90404,43513,46891,42.6833,26.3167
2012,Sliven,Tvarditsa,5662,2887,2775,42.7167,26.0167
2012,Sliven,Shivachevo,3635,1807,1828,42.7,26.0667
2012,Smolyan,Devin,6819,3258,3561,41.7444,24.3978
2012,Smolyan,Dospat,2357,1148,1209,41.6436,24.1667
2012,Smolyan,Zlatograd,7003,3351,3652,41.3833,25.1
2012,Smolyan,Madan,5734,2867,2867,41.4833,24.9333
2012,Smolyan,Nedelino,4393,2156,2237,41.5167,25.1
2012,Smolyan,Rudozem,3681,1797,1884,41.4833,24.85
2012,Smolyan,Smolyan,30045,14447,15598,41.5739,24.7128
2012,Smolyan,Chepelare,5254,2571,2683,41.7269,24.6833
2012,Sofia (stolitsa),Bankya,11200,5463,5737,42.6983,23.1342
2012,Sofia (stolitsa),Buhovo,2738,1355,1383,42.7667,23.4667
2012,Sofia (stolitsa),Novi Iskar,14532,7141,7391,42.8022,23.3006
2012,Sofia (stolitsa),Sofia,1213542,577716,635826,42.6977,23.3219
2012,Sofia (oblast),Bozhurishte,5691,2741,2950,42.755,23.1897
2012,Sofia (oblast),Botevgrad,20194,9834,10360,42.9119,23.8106
2012,Sofia (oblast),Godech,4315,2147,2168,43.0122,23.0447
2012,Sofia (oblast),Dolna Banya,4487,2210,2277,42.3,23.7833
2012,Sofia (oblast),Dragoman,3326,1637,1689,42.9225,23.0464
2012,Sofia (oblast),Elin Pelin,6885,3358,3527,42.6667,23.6
2012,Sofia (oblast),Etropole,10126,5031,5095,42.8333,24.0
2012,Sofia (oblast),Zlatitsa,5011,2433,2578,42.7,24.1333
2012,Sofia (oblast),Ihtiman,13045,6488,6557,42.4333,23.8167
2012,Sofia (oblast),Koprivshtitsa,2312,1125,1187,42.6333,24.35
2012,Sofia (oblast),Kostenets,6634,3240,3394,42.3086,23.8578
2012,Sofia (oblast),Kostinbrod,12012,5847,6165,42.8136,23.2178
2012,Sofia (oblast),Momin prohod,1587,751,836,42.4,23.85
2012,Sofia (oblast),Pirdop,7356,3598,3758,42.7,24.1833
2012,Sofia (oblast),Pravets,3787,1916,1871,42.8986,23.9142
2012,Sofia (oblast),Samokov,26441,12797,13644,42.3378,23.5528
2012,Sofia (oblast),Svoge,8096,4027,4069,42.9597,23.3408
2012,Sofia (oblast),Slivnitsa,7481,3731,3750,42.8511,23.0356
2012,Stara Zagora,Gurkovo,2772,1397,1375,42.65,25.8167
2012,Stara Zagora,Galabovo,8093,4066,4027,42.1333,25.8667
2012,Stara Zagora,Kazanlak,46725,22499,24226,42.6167,25.4
2012,Stara Zagora,Kran,3295,1638,1657,42.6658,25.3738
2012,Stara Zagora,Maglizh,3228,1608,1620,42.6167,25.5667
2012,Stara Zagora,Nikolaevo,2699,1323,1376,42.6833,25.85
2012,Stara Zagora,Pavel Banya,2704,1259,1445,42.6167,25.2
2012,Stara Zagora,Radnevo,12621,6275,6346,42.3,25.9333
2012,Stara Zagora,Stara Zagora,137881,66634,71247,42.4258,25.6347
2012,Stara Zagora,Chirpan,15266,7492,7774,42.2,25.3333
2012,Stara Zagora,Shipka,1280,618,662,42.7167,25.3333
2012,Targovishte,Antonovo,1537,772,765,43.15,26.1667
2012,Targovishte,Omurtag,7638,3598,4040,43.1,26.4167
2012,Targovishte,Opaka,2755,1376,1379,43.45,26.1667
2012,Targovishte,Popovo,15284,7361,7923,43.35,26.2333
2012,Targovishte,Targovishte,37089,17877,19212,43.25,26.5833
2012,Haskovo,Dimitrovgrad,37814,18425,19389,42.0519,25.5897
2012,Haskovo,Ivaylovgrad,3633,1816,1817,41.5283,26.1256
2012,Haskovo,Lyubimets,7526,3754,3772,41.8333,26.0833
2012,Haskovo,Madzharovo,624,321,303,41.6292,25.8667
2012,Haskovo,Merichleri,1608,786,822,42.0,25.8
2012,Haskovo,Svilengrad,18088,8896,9192,41.7667,26.2
2012,Haskovo,Simeonovgrad,6626,3273,3353,42.0333,25.8333
2012,Haskovo,Topolovgrad,5382,2680,2702,42.0844,26.3386
2012,Haskovo,Harmanli,18260,8966,9294,41.9333,25.9
2012,Haskovo,Haskovo,75334,36085,39249,41.9333,25.5667
2012,Shumen,Veliki Preslav,7593,3697,3896,43.1667,26.8167
2012,Shumen,Varbitsa,3315,1627,1688,43.1667,26.5833
2012,Shumen,Kaolinovo,1469,753,716,43.3167,27.0167
2012,Shumen,Kaspichan,3059,1505,1554,43.3167,27.1667
2012,Shumen,Novi Pazar,11855,5741,6114,43.35,27.2
2012,Shumen,Pliska,891,434,457,43.3667,27.1167
2012,Shumen,Smyadovo,3764,1873,1891,43.0333,27.05
2012,Shumen,Shumen,80143,38310,41833,43.2714,26.9361
2012,Yambol,Bolyarovo,1197,583,614,42.1,26.8333
2012,Yambol,Elhovo,10300,5031,5269,42.1667,26.5667
2012,Yambol,Straldzha,5707,2858,2849,42.6,26.6833
2012,Yambol,Yambol,72778,35466,37312,42.4833,26.5
2013,Blagoevgrad,Bansko,8867,4323,4544,41.8383,23.488
2013,Blagoevgrad,Belitsa,3236,1552,1684,41.9494,23.5725
2013,Blagoevgrad,Blagoevgrad,70583,33709,36874,42.0167,23.1
2013,Blagoevgrad,Gotse Delchev,18894,9104,9790,41.5667,23.7333
2013,Blagoevgrad,Dobrinishte,2761,1343,1418,41.825,23.5594
2013,Blagoevgrad,Kresna,3479,1752,1727,41.73,23.1569
2013,Blagoevgrad,Melnik,208,102,106,41.5231,23.3925
2013,Blagoevgrad,Petrich,28803,14009,14794,41.3981,23.2072
2013,Blagoevgrad,Razlog,11788,5713,6075,41.8864,23.4678
2013,Blagoevgrad,Sandanski,25858,12570,13288,41.5667,23.2833
2013,Blagoevgrad,Simitli,6590,3308,3282,41.8936,23.1069
2013,Blagoevgrad,Hadzhidimovo,2616,1330,1286,41.5167,23.8667
2013,Blagoevgrad,Yakoruda,5590,2695,2895,42.02,23.6833
2013,Burgas,Aytos,19708,9561,10147,42.7,27.25
2013,Burgas,Aheloy,2409,1220,1189,42.6483,27.6494
2013,Burgas,Ahtopol,1297,633,664,42.1,27.95
2013,Burgas,Burgas,199364,96173,103191,42.4975,27.47
2013,Burgas,Bulgarovo,1642,820,822,42.65,27.3333
2013,Burgas,Kableshkovo,2893,1428,1465,42.6167,27.5667
2013,Burgas,Kameno,4281,2096,2185,42.5667,27.3667
2013,Burgas,Karnobat,18000,8723,9277,42.65,26.9833
2013,Burgas,Kiten,929,469,460,42.2344,27.7711
2013,Burgas,Malko Tarnovo,2319,1143,1176,41.9833,27.5333
2013,Burgas,Nesebar,11231,5450,5781,42.66,27.72
2013,Burgas,Obzor,2177,1100,1077,42.8167,27.8833
2013,Burgas,Pomorie,13611,6558,7053,42.55,27.65
2013,Burgas,Primorsko,2977,1487,1490,42.2667,27.75
2013,Burgas,Sveti Vlas,3165,1641,1524,42.7167,27.7667
2013,Burgas,Sozopol,4284,2095,2189,42.4167,27.7
2013,Burgas,Sredets,8872,4326,4546,42.3483,27.1933
2013,Burgas,Sungurlare,3114,1539,1575,42.7667,26.7833
2013,Burgas,Tsarevo,6027,2960,3067,42.17,27.85
2013,Burgas,Chernomorets,2064,1023,1041,42.45,27.64
2013,Varna,Aksakovo,7928,3920,4008,43.2592,27.8211
2013,Varna,Beloslav,7675,3842,3833,43.19,27.7
2013,Varna,Byala,2041,1046,995,42.8833,27.8833
2013,Varna,Byala,2041,1046,995,43.4631,25.7214
2013,Varna,Varna,335819,163028,172791,43.2167,27.9167
2013,Varna,Valchi Dol,3138,1524,1614,43.4,27.5333
2013,Varna,Devnya,8036,3991,4045,43.2222,27.57
2013,Varna,Dolni Chiflik,6569,3236,3333,42.9833,27.7333
2013,Varna,Dalgopol,4700,2341,2359,43.05,27.35
2013,Varna,Ignatievo,4033,1962,2071,43.3,27.7
2013,Varna,Provadia,12783,6312,6471,43.1833,27.4333
2013,Varna,Suvorovo,4533,2248,2285,43.33,27.6
2013,Veliko Tarnovo,Byala Cherkva,1790,867,923,43.15,25.3
2013,Veliko Tarnovo,Veliko Tarnovo,68984,32801,36183,43.0833,25.65
2013,Veliko Tarnovo,Gorna Oryahovitsa,30708,14820,15888,43.1278,25.7019
2013,Veliko Tarnovo,Debelets,3984,1934,2050,43.0333,25.6167
2013,Veliko Tarnovo,Dolna Oryahovitsa,2838,1385,1453,43.1167,25.7833
2013,Veliko Tarnovo,Elena,5304,2545,2759,42.9333,25.8833
2013,Veliko Tarnovo,Zlataritsa,2124,1061,1063,43.05,25.9
2013,Veliko Tarnovo,Kilifarevo,2199,1062,1137,42.9833,25.6333
2013,Veliko Tarnovo,Lyaskovets,8025,3850,4175,43.1111,25.7261
2013,Veliko Tarnovo,Pavlikeni,10275,4998,5277,43.2428,25.3219
2013,Veliko Tarnovo,Polski Trambesh,4190,2104,2086,43.3667,25.65
2013,Veliko Tarnovo,Svishtov,28927,13825,15102,43.6239,25.3531
2013,Veliko Tarnovo,Strazhitsa,4372,2162,2210,43.2333,25.9667
2013,Veliko Tarnovo,Suhindol,1753,852,901,43.1833,25.2
2013,Vidin,Belogradchik,5013,2481,2532,43.6278,22.6833
2013,Vidin,Bregovo,2431,1173,1258,44.15,22.65
2013,Vidin,Vidin,46068,22432,23636,43.99,22.8725
2013,Vidin,Gramada,1369,674,695,43.8742,22.6783
2013,Vidin,Dimovo,1145,572,573,43.7417,22.7283
2013,Vidin,Dunavtsi,2156,1059,1097,44.0,22.8667
2013,Vidin,Kula,3016,1458,1558,43.89,22.5217
2013,Vratsa,Byala Slatina,10781,5242,5539,43.4667,23.9333
2013,Vratsa,Vratsa,57771,28164,29607,43.21,23.5625
2013,Vratsa,Kozloduy,12723,6324,6399,43.7833,23.7333
2013,Vratsa,Krivodol,2944,1461,1483,43.3683,23.4936
2013,Vratsa,Mezdra,10422,5018,5404,43.15,23.7
2013,Vratsa,Mizia,3102,1545,1557,43.6867,23.8458
2013,Vratsa,Oryahovo,4820,2364,2456,43.7358,23.9619
2013,Vratsa,Roman,2737,1354,1383,43.1369,24.125
2013,Gabrovo,Gabrovo,56995,27512,29483,42.8747,25.3186
2013,Gabrovo,Dryanovo,7186,3449,3737,42.9747,25.4781
2013,Gabrovo,Plachkovtsi,1716,859,857,42.8333,25.4333
2013,Gabrovo,Sevlievo,22046,10722,11324,43.0275,25.1125
2013,Gabrovo,Tryavna,9054,4341,4713,42.8672,25.5008
2013,Dobrich,Balchik,11580,5773,5807,43.4072,28.1672
2013,Dobrich,General Toshevo,6675,3288,3387,43.7,28.0333
2013,Dobrich,Dobrich,88807,42807,46000,43.5667,27.8333
2013,Dobrich,Kavarna,11321,5497,5824,43.4358,28.3386
2013,Dobrich,Tervel,5923,2905,3018,43.7472,27.41
2013,Dobrich,Shabla,3339,1642,1697,43.535,28.5339
2013,Kardzhali,Ardino,3462,1716,1746,41.5833,25.1333
2013,Kardzhali,Dzhebel,3149,1565,1584,41.4933,25.305
2013,Kardzhali,Krumovgrad,4888,2370,2518,41.4667,25.65
2013,Kardzhali,Kardzhali,43755,20986,22769,41.65,25.3667
2013,Kardzhali,Momchilgrad,7737,3827,3910,41.5258,25.4061
2013,Kyustendil,Bobovdol,5509,2965,2544,42.3522,23.0333
2013,Kyustendil,Boboshevo,1164,534,630,42.1461,23.0708
2013,Kyustendil,Dupnitsa,32369,15527,16842,42.2667,23.1167
2013,Kyustendil,Kocherinovo,2255,1069,1186,42.1167,23.0833
2013,Kyustendil,Kyustendil,42936,20669,22267,42.2833,22.6833
2013,Kyustendil,Rila,2332,1142,1190,42.13,23.3869
2013,Kyustendil,Sapareva Banya,3714,1838,1876,42.2889,23.2672
2013,Lovech,Apriltsi,2852,1372,1480,42.85,24.9167
2013,Lovech,Letnitsa,2597,1290,1307,43.2558,25.0639
2013,Lovech,Lovech,35254,17321,17933,43.1333,24.7167
2013,Lovech,Lukovit,8772,4301,4471,43.2,24.1667
2013,Lovech,Teteven,9443,4643,4800,42.9167,24.2667
2013,Lovech,Troyan,20536,9943,10593,42.89,24.7133
2013,Lovech,Ugarchin,2499,1231,1268,43.1,24.3167
2013,Lovech,Yablanitsa,2791,1405,1386,43.05,24.1
2013,Montana,Berkovitsa,12990,6328,6662,43.2392,23.1272
2013,Montana,Boychinovtsi,1446,737,709,43.4683,23.3044
2013,Montana,Brusartsi,1091,531,560,43.7,23.05
2013,Montana,Valchedram,3439,1664,1775,43.715,23.45
2013,Montana,Varshets,6071,2980,3091,43.1981,23.2875
2013,Montana,Lom,21787,10594,11193,43.8139,23.2369
2013,Montana,Montana,42426,20804,21622,43.4125,23.225
2013,Montana,Chiprovtsi,1776,874,902,43.3844,22.8822
2013,Pazardzhik,Batak,3121,1569,1552,41.9442,24.2181
2013,Pazardzhik,Belovo,3761,1814,1947,42.2122,24.015
2013,Pazardzhik,Bratsigovo,3983,1971,2012,42.0128,24.3742
2013,Pazardzhik,Velingrad,22165,10599,11566,42.0278,23.9908
2013,Pazardzhik,Vetren,3103,1548,1555,42.245,24.0894
2013,Pazardzhik,Kostandovo,4144,2076,2068,42.0656,24.0517
2013,Pazardzhik,Pazardzhik,70728,34302,36426,42.1922,24.3331
2013,Pazardzhik,Panagyurishte,17099,8433,8666,42.5,24.1833
2013,Pazardzhik,Peshtera,16557,8121,8436,42.0347,24.2994
2013,Pazardzhik,Rakitovo,8114,4006,4108,41.9878,24.0861
2013,Pazardzhik,Septemvri,7754,3822,3932,42.2167,24.1
2013,Pazardzhik,Strelcha,3945,1904,2041,42.5,24.3167
2013,Pazardzhik,Sarnitsa,3550,1799,1751,41.7858,24.015
2013,Pernik,Batanovtsi,2215,1099,1116,42.5539,23.0325
2013,Pernik,Breznik,4049,1985,2064,42.7394,22.9078
2013,Pernik,Zemen,1588,786,802,42.48,22.7489
2013,Pernik,Pernik,77382,37372,40010,42.6078,23.0375
2013,Pernik,Radomir,13951,6894,7057,42.5453,22.9775
2013,Pernik,Tran,2393,1190,1203,42.8342,22.6519
2013,Pleven,Belene,7997,4349,3648,43.6511,25.1133
2013,Pleven,Gulyantsi,3106,1511,1595,43.6486,24.7125
2013,Pleven,Dolna Mitropolia,2960,1438,1522,43.4667,24.5333
2013,Pleven,Dolni Dabnik,4070,1970,2100,43.4167,24.4333
2013,Pleven,Iskar,3037,1516,1521,43.4608,24.2686
2013,Pleven,Knezha,10110,4989,5121,43.5,24.0833
2013,Pleven,Koynare,3540,1758,1782,43.3667,24.0833
2013,Pleven,Levski,9601,4649,4952,43.4333,25.1333
2013,Pleven,Nikopol,3129,1545,1584,43.7081,24.8983
2013,Pleven,Pleven,103122,49661,53461,43.4167,24.6167
2013,Pleven,Pordim,1964,971,993,43.4167,24.9167
2013,Pleven,Slavyanovo,3772,1852,1920,43.3167,24.8667
2013,Pleven,Trastenik,4228,2073,2155,43.4833,24.55
2013,Pleven,Cherven Bryag,12309,6127,6182,43.2667,24.1
2013,Plovdiv,Asenovgrad,50186,24217,25969,42.0167,24.8667
2013,Plovdiv,Banya,3367,1586,1781,42.5,24.8333
2013,Plovdiv,Brezovo,1854,916,938,42.4833,25.0833
2013,Plovdiv,Kalofer,2932,1370,1562,42.6178,24.98
2013,Plovdiv,Karlovo,22656,10919,11737,42.6333,24.8
2013,Plovdiv,Klisura,1031,491,540,42.7,24.45
2013,Plovdiv,Krichim,8253,4085,4168,42.0333,24.4667
2013,Plovdiv,Kuklen,5816,2835,2981,42.0333,24.7833
2013,Plovdiv,Laki,2064,1055,1009,41.8167,24.8333
2013,Plovdiv,Perushtitsa,4960,2417,2543,42.0333,24.55
2013,Plovdiv,Plovdiv,341041,162664,178377,42.15,24.75
2013,Plovdiv,Parvomay,12983,6200,6783,42.1,25.2167
2013,Plovdiv,Rakovski,15016,7307,7709,42.2833,24.9333
2013,Plovdiv,Sadovo,2544,1269,1275,42.1333,24.8667
2013,Plovdiv,Sopot,8529,4137,4392,42.6667,24.75
2013,Plovdiv,Stamboliyski,11308,5472,5836,42.1333,24.5333
2013,Plovdiv,Saedinenie,5521,2717,2804,42.25,24.6
2013,Plovdiv,Hisarya,6852,3260,3592,42.5,24.7
2013,Razgrad,Zavet,2955,1477,1478,43.7333,26.5833
2013,Razgrad,Isperih,8602,4186,4416,43.7167,26.8333
2013,Razgrad,Kubrat,7046,3372,3674,43.8,26.5
2013,Razgrad,Loznitsa,2192,1079,1113,43.4333,26.6167
2013,Razgrad,Razgrad,32568,15396,17172,43.5333,26.5167
2013,Razgrad,Tsar Kaloyan,3614,1778,1836,43.6333,26.2333
2013,Ruse,Borovo,1954,970,984,43.5667,25.8167
2013,Ruse,Byala,8093,3990,4103,42.8833,27.8833
2013,Ruse,Byala,8093,3990,4103,43.4631,25.7214
2013,Ruse,Vetovo,4318,2167,2151,43.7,26.2667
2013,Ruse,Glodzhevo,3354,1674,1680,43.6833,26.5
2013,Ruse,Dve Mogili,4078,2025,2053,43.5,25.8833
2013,Ruse,Marten,3581,1796,1785,43.85,25.9333
2013,Ruse,Ruse,147817,71647,76170,43.8486,25.9534
2013,Ruse,Senovo,1353,667,686,43.6167,26.3167
2013,Ruse,Slivo pole,2927,1451,1476,43.85,26.2
2013,Ruse,Silistra,52118,25273,26845,44.1167,27.2667
2013,Ruse,Silistra,52118,25273,26845,44.1167,27.2667
2013,Ruse,Alfatar,1561,781,780,43.95,27.3
2013,Ruse,Glavinitsa,1521,730,791,43.9333,26.8333
2013,Ruse,Dulovo,6447,3193,3254,43.8333,27.1333
2013,Ruse,Silistra,34216,16469,17747,44.1167,27.2667
2013,Ruse,Silistra,34216,16469,17747,44.1167,27.2667
2013,Ruse,Tutrakan,8373,4100,4273,44.05,26.6167
2013,Sliven,Kermen,1671,841,830,42.6333,26.1333
2013,Sliven,Kotel,5564,2656,2908,42.8833,26.45
2013,Sliven,Nova Zagora,21929,10675,11254,42.4833,26.0167
2013,Sliven,Sliven,89723,43121,46602,42.6833,26.3167
2013,Sliven,Tvarditsa,5649,2875,2774,42.7167,26.0167
2013,Sliven,Shivachevo,3605,1789,1816,42.7,26.0667
2013,Smolyan,Devin,6618,3167,3451,41.7444,24.3978
2013,Smolyan,Dospat,2324,1132,1192,41.6436,24.1667
2013,Smolyan,Zlatograd,6867,3283,3584,41.3833,25.1
2013,Smolyan,Madan,5652,2821,2831,41.4833,24.9333
2013,Smolyan,Nedelino,4298,2101,2197,41.5167,25.1
2013,Smolyan,Rudozem,3610,1759,1851,41.4833,24.85
2013,Smolyan,Smolyan,29562,14221,15341,41.5739,24.7128
2013,Smolyan,Chepelare,5156,2540,2616,41.7269,24.6833
2013,Sofia (stolitsa),Bankya,11240,5483,5757,42.6983,23.1342
2013,Sofia (stolitsa),Buhovo,2727,1343,1384,42.7667,23.4667
2013,Sofia (stolitsa),Novi Iskar,14406,7080,7326,42.8022,23.3006
2013,Sofia (stolitsa),Sofia,1221292,582085,639207,42.6977,23.3219
2013,Sofia (oblast),Bozhurishte,5641,2721,2920,42.755,23.1897
2013,Sofia (oblast),Botevgrad,20103,9775,10328,42.9119,23.8106
2013,Sofia (oblast),Godech,4255,2122,2133,43.0122,23.0447
2013,Sofia (oblast),Dolna Banya,4497,2208,2289,42.3,23.7833
2013,Sofia (oblast),Dragoman,3308,1630,1678,42.9225,23.0464
2013,Sofia (oblast),Elin Pelin,6849,3338,3511,42.6667,23.6
2013,Sofia (oblast),Etropole,10018,4962,5056,42.8333,24.0
2013,Sofia (oblast),Zlatitsa,4936,2407,2529,42.7,24.1333
2013,Sofia (oblast),Ihtiman,13022,6471,6551,42.4333,23.8167
2013,Sofia (oblast),Koprivshtitsa,2287,1115,1172,42.6333,24.35
2013,Sofia (oblast),Kostenets,6502,3184,3318,42.3086,23.8578
2013,Sofia (oblast),Kostinbrod,11904,5804,6100,42.8136,23.2178
2013,Sofia (oblast),Momin prohod,1555,733,822,42.4,23.85
2013,Sofia (oblast),Pirdop,7263,3554,3709,42.7,24.1833
2013,Sofia (oblast),Pravets,3762,1904,1858,42.8986,23.9142
2013,Sofia (oblast),Samokov,26263,12691,13572,42.3378,23.5528
2013,Sofia (oblast),Svoge,8017,3986,4031,42.9597,23.3408
2013,Sofia (oblast),Slivnitsa,7379,3666,3713,42.8511,23.0356
2013,Stara Zagora,Gurkovo,2739,1378,1361,42.65,25.8167
2013,Stara Zagora,Galabovo,8006,4015,3991,42.1333,25.8667
2013,Stara Zagora,Kazanlak,46380,22323,24057,42.6167,25.4
2013,Stara Zagora,Kran,3251,1615,1636,42.6658,25.3738
2013,Stara Zagora,Maglizh,3221,1607,1614,42.6167,25.5667
2013,Stara Zagora,Nikolaevo,2746,1345,1401,42.6833,25.85
2013,Stara Zagora,Pavel Banya,2654,1235,1419,42.6167,25.2
2013,Stara Zagora,Radnevo,12501,6219,6282,42.3,25.9333
2013,Stara Zagora,Stara Zagora,137834,66508,71326,42.4258,25.6347
2013,Stara Zagora,Chirpan,15109,7418,7691,42.2,25.3333
2013,Stara Zagora,Shipka,1260,604,656,42.7167,25.3333
2013,Targovishte,Antonovo,1516,753,763,43.15,26.1667
2013,Targovishte,Omurtag,7576,3565,4011,43.1,26.4167
2013,Targovishte,Opaka,2727,1361,1366,43.45,26.1667
2013,Targovishte,Popovo,15148,7305,7843,43.35,26.2333
2013,Targovishte,Targovishte,36797,17716,19081,43.25,26.5833
2013,Haskovo,Dimitrovgrad,37381,18206,19175,42.0519,25.5897
2013,Haskovo,Ivaylovgrad,3584,1791,1793,41.5283,26.1256
2013,Haskovo,Lyubimets,7436,3715,3721,41.8333,26.0833
2013,Haskovo,Madzharovo,618,312,306,41.6292,25.8667
2013,Haskovo,Merichleri,1602,789,813,42.0,25.8
2013,Haskovo,Svilengrad,18064,8895,9169,41.7667,26.2
2013,Haskovo,Simeonovgrad,6526,3227,3299,42.0333,25.8333
2013,Haskovo,Topolovgrad,5287,2622,2665,42.0844,26.3386
2013,Haskovo,Harmanli,18147,8906,9241,41.9333,25.9
2013,Haskovo,Haskovo,74826,35840,38986,41.9333,25.5667
2013,Shumen,Veliki Preslav,7555,3692,3863,43.1667,26.8167
2013,Shumen,Varbitsa,3315,1618,1697,43.1667,26.5833
2013,Shumen,Kaolinovo,1470,753,717,43.3167,27.0167
2013,Shumen,Kaspichan,2987,1472,1515,43.3167,27.1667
2013,Shumen,Novi Pazar,11875,5747,6128,43.35,27.2
2013,Shumen,Pliska,887,431,456,43.3667,27.1167
2013,Shumen,Smyadovo,3736,1845,1891,43.0333,27.05
2013,Shumen,Shumen,79710,38155,41555,43.2714,26.9361
2013,Yambol,Bolyarovo,1172,576,596,42.1,26.8333
2013,Yambol,Elhovo,10124,4945,5179,42.1667,26.5667
2013,Yambol,Straldzha,5720,2875,2845,42.6,26.6833
2013,Yambol,Yambol,72159,35143,37016,42.4833,26.5
2014,Blagoevgrad,Bansko,8834,4300,4534,41.8383,23.488
2014,Blagoevgrad,Belitsa,3196,1525,1671,41.9494,23.5725
2014,Blagoevgrad,Blagoevgrad,70293,33423,36870,42.0167,23.1
2014,Blagoevgrad,Gotse Delchev,18814,9047,9767,41.5667,23.7333
2014,Blagoevgrad,Dobrinishte,2740,1328,1412,41.825,23.5594
2014,Blagoevgrad,Kresna,3422,1729,1693,41.73,23.1569
2014,Blagoevgrad,Melnik,209,105,104,41.5231,23.3925
2014,Blagoevgrad,Petrich,28431,13779,14652,41.3981,23.2072
2014,Blagoevgrad,Razlog,11744,5677,6067,41.8864,23.4678
2014,Blagoevgrad,Sandanski,25676,12404,13272,41.5667,23.2833
2014,Blagoevgrad,Simitli,6605,3316,3289,41.8936,23.1069
2014,Blagoevgrad,Hadzhidimovo,2595,1326,1269,41.5167,23.8667
2014,Blagoevgrad,Yakoruda,5544,2659,2885,42.02,23.6833
2014,Burgas,Aytos,19615,9525,10090,42.7,27.25
2014,Burgas,Aheloy,2384,1210,1174,42.6483,27.6494
2014,Burgas,Ahtopol,1290,633,657,42.1,27.95
2014,Burgas,Burgas,198725,95255,103470,42.4975,27.47
2014,Burgas,Bulgarovo,1619,808,811,42.65,27.3333
2014,Burgas,Kableshkovo,2908,1433,1475,42.6167,27.5667
2014,Burgas,Kameno,4231,2083,2148,42.5667,27.3667
2014,Burgas,Karnobat,17875,8668,9207,42.65,26.9833
2014,Burgas,Kiten,937,470,467,42.2344,27.7711
2014,Burgas,Malko Tarnovo,2239,1102,1137,41.9833,27.5333
2014,Burgas,Nesebar,11756,5678,6078,42.66,27.72
2014,Burgas,Obzor,2362,1186,1176,42.8167,27.8833
2014,Burgas,Pomorie,13662,6564,7098,42.55,27.65
2014,Burgas,Primorsko,2996,1483,1513,42.2667,27.75
2014,Burgas,Sveti Vlas,3405,1736,1669,42.7167,27.7667
2014,Burgas,Sozopol,4288,2094,2194,42.4167,27.7
2014,Burgas,Sredets,8831,4317,4514,42.3483,27.1933
2014,Burgas,Sungurlare,3077,1530,1547,42.7667,26.7833
2014,Burgas,Tsarevo,5998,2938,3060,42.17,27.85
2014,Burgas,Chernomorets,2079,1033,1046,42.45,27.64
2014,Varna,Aksakovo,7913,3915,3998,43.2592,27.8211
2014,Varna,Beloslav,7598,3795,3803,43.19,27.7
2014,Varna,Byala,2084,1057,1027,42.8833,27.8833
2014,Varna,Byala,2084,1057,1027,43.4631,25.7214
2014,Varna,Varna,335949,163011,172938,43.2167,27.9167
2014,Varna,Valchi Dol,3061,1486,1575,43.4,27.5333
2014,Varna,Devnya,7969,3947,4022,43.2222,27.57
2014,Varna,Dolni Chiflik,6544,3218,3326,42.9833,27.7333
2014,Varna,Dalgopol,4621,2307,2314,43.05,27.35
2014,Varna,Ignatievo,4005,1944,2061,43.3,27.7
2014,Varna,Provadia,12557,6192,6365,43.1833,27.4333
2014,Varna,Suvorovo,4537,2252,2285,43.33,27.6
2014,Veliko Tarnovo,Byala Cherkva,1768,865,903,43.15,25.3
2014,Veliko Tarnovo,Veliko Tarnovo,68676,32676,36000,43.0833,25.65
2014,Veliko Tarnovo,Gorna Oryahovitsa,30317,14601,15716,43.1278,25.7019
2014,Veliko Tarnovo,Debelets,3946,1916,2030,43.0333,25.6167
2014,Veliko Tarnovo,Dolna Oryahovitsa,2778,1345,1433,43.1167,25.7833
2014,Veliko Tarnovo,Elena,5212,2499,2713,42.9333,25.8833
2014,Veliko Tarnovo,Zlataritsa,2093,1044,1049,43.05,25.9
2014,Veliko Tarnovo,Kilifarevo,2196,1065,1131,42.9833,25.6333
2014,Veliko Tarnovo,Lyaskovets,7891,3774,4117,43.1111,25.7261
2014,Veliko Tarnovo,Pavlikeni,10075,4884,5191,43.2428,25.3219
2014,Veliko Tarnovo,Polski Trambesh,4106,2043,2063,43.3667,25.65
2014,Veliko Tarnovo,Svishtov,28163,13541,14622,43.6239,25.3531
2014,Veliko Tarnovo,Strazhitsa,4386,2166,2220,43.2333,25.9667
2014,Veliko Tarnovo,Suhindol,1720,851,869,43.1833,25.2
2014,Vidin,Belogradchik,4924,2433,2491,43.6278,22.6833
2014,Vidin,Bregovo,2366,1142,1224,44.15,22.65
2014,Vidin,Vidin,45327,22081,23246,43.99,22.8725
2014,Vidin,Gramada,1352,663,689,43.8742,22.6783
2014,Vidin,Dimovo,1133,559,574,43.7417,22.7283
2014,Vidin,Dunavtsi,2086,1022,1064,44.0,22.8667
2014,Vidin,Kula,2930,1416,1514,43.89,22.5217
2014,Vratsa,Byala Slatina,10631,5178,5453,43.4667,23.9333
2014,Vratsa,Vratsa,56517,27500,29017,43.21,23.5625
2014,Vratsa,Kozloduy,12606,6263,6343,43.7833,23.7333
2014,Vratsa,Krivodol,2879,1432,1447,43.3683,23.4936
2014,Vratsa,Mezdra,10176,4905,5271,43.15,23.7
2014,Vratsa,Mizia,2963,1491,1472,43.6867,23.8458
2014,Vratsa,Oryahovo,4734,2319,2415,43.7358,23.9619
2014,Vratsa,Roman,2686,1320,1366,43.1369,24.125
2014,Gabrovo,Gabrovo,56003,27038,28965,42.8747,25.3186
2014,Gabrovo,Dryanovo,7110,3422,3688,42.9747,25.4781
2014,Gabrovo,Plachkovtsi,1677,842,835,42.8333,25.4333
2014,Gabrovo,Sevlievo,21717,10549,11168,43.0275,25.1125
2014,Gabrovo,Tryavna,8897,4253,4644,42.8672,25.5008
2014,Dobrich,Balchik,11544,5733,5811,43.4072,28.1672
2014,Dobrich,General Toshevo,6551,3238,3313,43.7,28.0333
2014,Dobrich,Dobrich,87817,42211,45606,43.5667,27.8333
2014,Dobrich,Kavarna,11212,5441,5771,43.4358,28.3386
2014,Dobrich,Tervel,5862,2883,2979,43.7472,27.41
2014,Dobrich,Shabla,3270,1606,1664,43.535,28.5339
2014,Kardzhali,Ardino,3531,1762,1769,41.5833,25.1333
2014,Kardzhali,Dzhebel,3132,1551,1581,41.4933,25.305
2014,Kardzhali,Krumovgrad,4816,2329,2487,41.4667,25.65
2014,Kardzhali,Kardzhali,43668,20895,22773,41.65,25.3667
2014,Kardzhali,Momchilgrad,7727,3815,3912,41.5258,25.4061
2014,Kyustendil,Bobovdol,5382,2876,2506,42.3522,23.0333
2014,Kyustendil,Boboshevo,1168,538,630,42.1461,23.0708
2014,Kyustendil,Dupnitsa,31868,15300,16568,42.2667,23.1167
2014,Kyustendil,Kocherinovo,2184,1035,1149,42.1167,23.0833
2014,Kyustendil,Kyustendil,42266,20346,21920,42.2833,22.6833
2014,Kyustendil,Rila,2275,1109,1166,42.13,23.3869
2014,Kyustendil,Sapareva Banya,3682,1823,1859,42.2889,23.2672
2014,Lovech,Apriltsi,2813,1369,1444,42.85,24.9167
2014,Lovech,Letnitsa,2547,1262,1285,43.2558,25.0639
2014,Lovech,Lovech,34752,17035,17717,43.1333,24.7167
2014,Lovech,Lukovit,8689,4252,4437,43.2,24.1667
2014,Lovech,Teteven,9281,4534,4747,42.9167,24.2667
2014,Lovech,Troyan,20280,9808,10472,42.89,24.7133
2014,Lovech,Ugarchin,2479,1226,1253,43.1,24.3167
2014,Lovech,Yablanitsa,2756,1391,1365,43.05,24.1
2014,Montana,Berkovitsa,12726,6208,6518,43.2392,23.1272
2014,Montana,Boychinovtsi,1380,700,680,43.4683,23.3044
2014,Montana,Brusartsi,1061,516,545,43.7,23.05
2014,Montana,Valchedram,3393,1632,1761,43.715,23.45
2014,Montana,Varshets,5996,2954,3042,43.1981,23.2875
2014,Montana,Lom,21466,10429,11037,43.8139,23.2369
2014,Montana,Montana,41814,20453,21361,43.4125,23.225
2014,Montana,Chiprovtsi,1736,856,880,43.3844,22.8822
2014,Pazardzhik,Batak,3037,1527,1510,41.9442,24.2181
2014,Pazardzhik,Belovo,3676,1788,1888,42.2122,24.015
2014,Pazardzhik,Bratsigovo,3969,1957,2012,42.0128,24.3742
2014,Pazardzhik,Velingrad,21942,10460,11482,42.0278,23.9908
2014,Pazardzhik,Vetren,3010,1503,1507,42.245,24.0894
2014,Pazardzhik,Kostandovo,4104,2046,2058,42.0656,24.0517
2014,Pazardzhik,Pazardzhik,70321,34045,36276,42.1922,24.3331
2014,Pazardzhik,Panagyurishte,16868,8306,8562,42.5,24.1833
2014,Pazardzhik,Peshtera,16459,8057,8402,42.0347,24.2994
2014,Pazardzhik,Rakitovo,8066,3971,4095,41.9878,24.0861
2014,Pazardzhik,Septemvri,7658,3773,3885,42.2167,24.1
2014,Pazardzhik,Strelcha,3929,1890,2039,42.5,24.3167
2014,Pazardzhik,Sarnitsa,3521,1789,1732,41.7858,24.015
2014,Pernik,Batanovtsi,2188,1078,1110,42.5539,23.0325
2014,Pernik,Breznik,3999,1946,2053,42.7394,22.9078
2014,Pernik,Zemen,1648,825,823,42.48,22.7489
2014,Pernik,Pernik,76247,36787,39460,42.6078,23.0375
2014,Pernik,Radomir,13816,6818,6998,42.5453,22.9775
2014,Pernik,Tran,2356,1175,1181,42.8342,22.6519
2014,Pleven,Belene,7803,4240,3563,43.6511,25.1133
2014,Pleven,Gulyantsi,3062,1496,1566,43.6486,24.7125
2014,Pleven,Dolna Mitropolia,2912,1412,1500,43.4667,24.5333
2014,Pleven,Dolni Dabnik,3996,1924,2072,43.4167,24.4333
2014,Pleven,Iskar,2998,1489,1509,43.4608,24.2686
2014,Pleven,Knezha,9909,4880,5029,43.5,24.0833
2014,Pleven,Koynare,3479,1727,1752,43.3667,24.0833
2014,Pleven,Levski,9451,4572,4879,43.4333,25.1333
2014,Pleven,Nikopol,3109,1531,1578,43.7081,24.8983
2014,Pleven,Pleven,101978,49001,52977,43.4167,24.6167
2014,Pleven,Pordim,1951,970,981,43.4167,24.9167
2014,Pleven,Slavyanovo,3741,1836,1905,43.3167,24.8667
2014,Pleven,Trastenik,4196,2054,2142,43.4833,24.55
2014,Pleven,Cherven Bryag,12178,6057,6121,43.2667,24.1
2014,Plovdiv,Asenovgrad,49884,24020,25864,42.0167,24.8667
2014,Plovdiv,Banya,3339,1567,1772,42.5,24.8333
2014,Plovdiv,Brezovo,1814,893,921,42.4833,25.0833
2014,Plovdiv,Kalofer,2914,1358,1556,42.6178,24.98
2014,Plovdiv,Karlovo,22335,10735,11600,42.6333,24.8
2014,Plovdiv,Klisura,1022,487,535,42.7,24.45
2014,Plovdiv,Krichim,8190,4042,4148,42.0333,24.4667
2014,Plovdiv,Kuklen,5813,2839,2974,42.0333,24.7833
2014,Plovdiv,Laki,2037,1031,1006,41.8167,24.8333
2014,Plovdiv,Perushtitsa,4931,2398,2533,42.0333,24.55
2014,Plovdiv,Plovdiv,341567,162776,178791,42.15,24.75
2014,Plovdiv,Parvomay,12860,6131,6729,42.1,25.2167
2014,Plovdiv,Rakovski,14921,7247,7674,42.2833,24.9333
2014,Plovdiv,Sadovo,2502,1257,1245,42.1333,24.8667
2014,Plovdiv,Sopot,8469,4099,4370,42.6667,24.75
2014,Plovdiv,Stamboliyski,11213,5407,5806,42.1333,24.5333
2014,Plovdiv,Saedinenie,5506,2709,2797,42.25,24.6
2014,Plovdiv,Hisarya,6761,3200,3561,42.5,24.7
2014,Razgrad,Zavet,2894,1445,1449,43.7333,26.5833
2014,Razgrad,Isperih,8497,4140,4357,43.7167,26.8333
2014,Razgrad,Kubrat,6926,3311,3615,43.8,26.5
2014,Razgrad,Loznitsa,2157,1064,1093,43.4333,26.6167
2014,Razgrad,Razgrad,32220,15230,16990,43.5333,26.5167
2014,Razgrad,Tsar Kaloyan,3550,1745,1805,43.6333,26.2333
2014,Ruse,Borovo,1916,942,974,43.5667,25.8167
2014,Ruse,Byala,7959,3924,4035,42.8833,27.8833
2014,Ruse,Byala,7959,3924,4035,43.4631,25.7214
2014,Ruse,Vetovo,4256,2148,2108,43.7,26.2667
2014,Ruse,Glodzhevo,3291,1647,1644,43.6833,26.5
2014,Ruse,Dve Mogili,4027,1993,2034,43.5,25.8833
2014,Ruse,Marten,3539,1768,1771,43.85,25.9333
2014,Ruse,Ruse,147055,71315,75740,43.8486,25.9534
2014,Ruse,Senovo,1338,662,676,43.6167,26.3167
2014,Ruse,Slivo pole,2917,1441,1476,43.85,26.2
2014,Ruse,Silistra,51429,24868,26561,44.1167,27.2667
2014,Ruse,Silistra,51429,24868,26561,44.1167,27.2667
2014,Ruse,Alfatar,1509,742,767,43.95,27.3
2014,Ruse,Glavinitsa,1491,714,777,43.9333,26.8333
2014,Ruse,Dulovo,6472,3184,3288,43.8333,27.1333
2014,Ruse,Silistra,33683,16185,17498,44.1167,27.2667
2014,Ruse,Silistra,33683,16185,17498,44.1167,27.2667
2014,Ruse,Tutrakan,8274,4043,4231,44.05,26.6167
2014,Sliven,Kermen,1632,822,810,42.6333,26.1333
2014,Sliven,Kotel,5460,2613,2847,42.8833,26.45
2014,Sliven,Nova Zagora,21822,10621,11201,42.4833,26.0167
2014,Sliven,Sliven,89065,42768,46297,42.6833,26.3167
2014,Sliven,Tvarditsa,5663,2872,2791,42.7167,26.0167
2014,Sliven,Shivachevo,3634,1811,1823,42.7,26.0667
2014,Smolyan,Devin,6485,3101,3384,41.7444,24.3978
2014,Smolyan,Dospat,2294,1115,1179,41.6436,24.1667
2014,Smolyan,Zlatograd,6715,3190,3525,41.3833,25.1
2014,Smolyan,Madan,5587,2791,2796,41.4833,24.9333
2014,Smolyan,Nedelino,4185,2043,2142,41.5167,25.1
2014,Smolyan,Rudozem,3576,1738,1838,41.4833,24.85
2014,Smolyan,Smolyan,29124,13996,15128,41.5739,24.7128
2014,Smolyan,Chepelare,5084,2481,2603,41.7269,24.6833
2014,Sofia (stolitsa),Bankya,11359,5549,5810,42.6983,23.1342
2014,Sofia (stolitsa),Buhovo,2670,1318,1352,42.7667,23.4667
2014,Sofia (stolitsa),Novi Iskar,14356,7048,7308,42.8022,23.3006
2014,Sofia (stolitsa),Sofia,1228282,585833,642449,42.6977,23.3219
2014,Sofia (oblast),Bozhurishte,5622,2726,2896,42.755,23.1897
2014,Sofia (oblast),Botevgrad,19889,9635,10254,42.9119,23.8106
2014,Sofia (oblast),Godech,4188,2087,2101,43.0122,23.0447
2014,Sofia (oblast),Dolna Banya,4510,2209,2301,42.3,23.7833
2014,Sofia (oblast),Dragoman,3268,1605,1663,42.9225,23.0464
2014,Sofia (oblast),Elin Pelin,6878,3350,3528,42.6667,23.6
2014,Sofia (oblast),Etropole,9855,4860,4995,42.8333,24.0
2014,Sofia (oblast),Zlatitsa,4845,2365,2480,42.7,24.1333
2014,Sofia (oblast),Ihtiman,12930,6415,6515,42.4333,23.8167
2014,Sofia (oblast),Koprivshtitsa,2231,1096,1135,42.6333,24.35
2014,Sofia (oblast),Kostenets,6379,3117,3262,42.3086,23.8578
2014,Sofia (oblast),Kostinbrod,11788,5752,6036,42.8136,23.2178
2014,Sofia (oblast),Momin prohod,1515,710,805,42.4,23.85
2014,Sofia (oblast),Pirdop,7148,3488,3660,42.7,24.1833
2014,Sofia (oblast),Pravets,3723,1880,1843,42.8986,23.9142
2014,Sofia (oblast),Samokov,25967,12520,13447,42.3378,23.5528
2014,Sofia (oblast),Svoge,7875,3905,3970,42.9597,23.3408
2014,Sofia (oblast),Slivnitsa,7295,3620,3675,42.8511,23.0356
2014,Stara Zagora,Gurkovo,2705,1363,1342,42.65,25.8167
2014,Stara Zagora,Galabovo,7957,4020,3937,42.1333,25.8667
2014,Stara Zagora,Kazanlak,45994,22119,23875,42.6167,25.4
2014,Stara Zagora,Kran,3250,1613,1637,42.6658,25.3738
2014,Stara Zagora,Maglizh,3172,1579,1593,42.6167,25.5667
2014,Stara Zagora,Nikolaevo,2750,1352,1398,42.6833,25.85
2014,Stara Zagora,Pavel Banya,2621,1227,1394,42.6167,25.2
2014,Stara Zagora,Radnevo,12322,6124,6198,42.3,25.9333
2014,Stara Zagora,Stara Zagora,137729,66421,71308,42.4258,25.6347
2014,Stara Zagora,Chirpan,14890,7295,7595,42.2,25.3333
2014,Stara Zagora,Shipka,1227,588,639,42.7167,25.3333
2014,Targovishte,Antonovo,1501,745,756,43.15,26.1667
2014,Targovishte,Omurtag,7457,3513,3944,43.1,26.4167
2014,Targovishte,Opaka,2661,1331,1330,43.45,26.1667
2014,Targovishte,Popovo,14945,7199,7746,43.35,26.2333
2014,Targovishte,Targovishte,36384,17464,18920,43.25,26.5833
2014,Haskovo,Dimitrovgrad,36737,17819,18918,42.0519,25.5897
2014,Haskovo,Ivaylovgrad,3504,1746,1758,41.5283,26.1256
2014,Haskovo,Lyubimets,7331,3642,3689,41.8333,26.0833
2014,Haskovo,Madzharovo,618,309,309,41.6292,25.8667
2014,Haskovo,Merichleri,1578,774,804,42.0,25.8
2014,Haskovo,Svilengrad,18135,8986,9149,41.7667,26.2
2014,Haskovo,Simeonovgrad,6370,3158,3212,42.0333,25.8333
2014,Haskovo,Topolovgrad,5181,2563,2618,42.0844,26.3386
2014,Haskovo,Harmanli,18986,9472,9514,41.9333,25.9
2014,Haskovo,Haskovo,73819,35291,38528,41.9333,25.5667
2014,Shumen,Veliki Preslav,7460,3653,3807,43.1667,26.8167
2014,Shumen,Varbitsa,3301,1609,1692,43.1667,26.5833
2014,Shumen,Kaolinovo,1491,765,726,43.3167,27.0167
2014,Shumen,Kaspichan,2914,1439,1475,43.3167,27.1667
2014,Shumen,Novi Pazar,11724,5677,6047,43.35,27.2
2014,Shumen,Pliska,877,424,453,43.3667,27.1167
2014,Shumen,Smyadovo,3699,1829,1870,43.0333,27.05
2014,Shumen,Shumen,78884,37795,41089,43.2714,26.9361
2014,Yambol,Bolyarovo,1156,564,592,42.1,26.8333
2014,Yambol,Elhovo,9978,4881,5097,42.1667,26.5667
2014,Yambol,Straldzha,5703,2859,2844,42.6,26.6833
2014,Yambol,Yambol,71561,34803,36758,42.4833,26.5
2015,Blagoevgrad,Bansko,8868,4337,4531,41.8383,23.488
2015,Blagoevgrad,Belitsa,3148,1499,1649,41.9494,23.5725
2015,Blagoevgrad,Blagoevgrad,69610,33020,36590,42.0167,23.1
2015,Blagoevgrad,Gotse Delchev,18617,8906,9711,41.5667,23.7333
2015,Blagoevgrad,Dobrinishte,2723,1318,1405,41.825,23.5594
2015,Blagoevgrad,Kresna,3513,1787,1726,41.73,23.1569
2015,Blagoevgrad,Melnik,208,102,106,41.5231,23.3925
2015,Blagoevgrad,Petrich,27822,13384,14438,41.3981,23.2072
2015,Blagoevgrad,Razlog,11655,5628,6027,41.8864,23.4678
2015,Blagoevgrad,Sandanski,25279,12177,13102,41.5667,23.2833
2015,Blagoevgrad,Simitli,6534,3279,3255,41.8936,23.1069
2015,Blagoevgrad,Hadzhidimovo,2565,1314,1251,41.5167,23.8667
2015,Blagoevgrad,Yakoruda,5453,2604,2849,42.02,23.6833
2015,Burgas,Aytos,19462,9421,10041,42.7,27.25
2015,Burgas,Aheloy,2352,1184,1168,42.6483,27.6494
2015,Burgas,Ahtopol,1289,635,654,42.1,27.95
2015,Burgas,Burgas,203017,97027,105990,42.4975,27.47
2015,Burgas,Bulgarovo,1601,802,799,42.65,27.3333
2015,Burgas,Kableshkovo,2901,1437,1464,42.6167,27.5667
2015,Burgas,Kameno,4219,2075,2144,42.5667,27.3667
2015,Burgas,Karnobat,17608,8561,9047,42.65,26.9833
2015,Burgas,Kiten,959,481,478,42.2344,27.7711
2015,Burgas,Malko Tarnovo,2227,1111,1116,41.9833,27.5333
2015,Burgas,Nesebar,12275,5919,6356,42.66,27.72
2015,Burgas,Obzor,2501,1271,1230,42.8167,27.8833
2015,Burgas,Pomorie,13596,6525,7071,42.55,27.65
2015,Burgas,Primorsko,2989,1493,1496,42.2667,27.75
2015,Burgas,Sveti Vlas,3638,1853,1785,42.7167,27.7667
2015,Burgas,Sozopol,4370,2128,2242,42.4167,27.7
2015,Burgas,Sredets,8859,4365,4494,42.3483,27.1933
2015,Burgas,Sungurlare,3049,1510,1539,42.7667,26.7833
2015,Burgas,Tsarevo,5966,2933,3033,42.17,27.85
2015,Burgas,Chernomorets,2109,1047,1062,42.45,27.64
2015,Varna,Aksakovo,7853,3887,3966,43.2592,27.8211
2015,Varna,Beloslav,7527,3752,3775,43.19,27.7
2015,Varna,Byala,2112,1071,1041,42.8833,27.8833
2015,Varna,Byala,2112,1071,1041,43.4631,25.7214
2015,Varna,Varna,334466,162072,172394,43.2167,27.9167
2015,Varna,Valchi Dol,2994,1459,1535,43.4,27.5333
2015,Varna,Devnya,7930,3923,4007,43.2222,27.57
2015,Varna,Dolni Chiflik,6518,3208,3310,42.9833,27.7333
2015,Varna,Dalgopol,4574,2287,2287,43.05,27.35
2015,Varna,Ignatievo,3989,1949,2040,43.3,27.7
2015,Varna,Provadia,12273,6035,6238,43.1833,27.4333
2015,Varna,Suvorovo,4557,2262,2295,43.33,27.6
2015,Veliko Tarnovo,Byala Cherkva,1736,850,886,43.15,25.3
2015,Veliko Tarnovo,Veliko Tarnovo,68320,32508,35812,43.0833,25.65
2015,Veliko Tarnovo,Gorna Oryahovitsa,29841,14397,15444,43.1278,25.7019
2015,Veliko Tarnovo,Debelets,3893,1899,1994,43.0333,25.6167
2015,Veliko Tarnovo,Dolna Oryahovitsa,2734,1322,1412,43.1167,25.7833
2015,Veliko Tarnovo,Elena,5122,2456,2666,42.9333,25.8833
2015,Veliko Tarnovo,Zlataritsa,2105,1051,1054,43.05,25.9
2015,Veliko Tarnovo,Kilifarevo,2159,1048,1111,42.9833,25.6333
2015,Veliko Tarnovo,Lyaskovets,7829,3739,4090,43.1111,25.7261
2015,Veliko Tarnovo,Pavlikeni,9851,4755,5096,43.2428,25.3219
2015,Veliko Tarnovo,Polski Trambesh,4057,2020,2037,43.3667,25.65
2015,Veliko Tarnovo,Svishtov,27487,13228,14259,43.6239,25.3531
2015,Veliko Tarnovo,Strazhitsa,4346,2158,2188,43.2333,25.9667
2015,Veliko Tarnovo,Suhindol,1735,862,873,43.1833,25.2
2015,Vidin,Belogradchik,4778,2362,2416,43.6278,22.6833
2015,Vidin,Bregovo,2345,1131,1214,44.15,22.65
2015,Vidin,Vidin,43595,21153,22442,43.99,22.8725
2015,Vidin,Gramada,1411,714,697,43.8742,22.6783
2015,Vidin,Dimovo,1115,541,574,43.7417,22.7283
2015,Vidin,Dunavtsi,2022,988,1034,44.0,22.8667
2015,Vidin,Kula,2821,1367,1454,43.89,22.5217
2015,Vratsa,Byala Slatina,10363,5038,5325,43.4667,23.9333
2015,Vratsa,Vratsa,54150,26228,27922,43.21,23.5625
2015,Vratsa,Kozloduy,12354,6112,6242,43.7833,23.7333
2015,Vratsa,Krivodol,2780,1386,1394,43.3683,23.4936
2015,Vratsa,Mezdra,9709,4675,5034,43.15,23.7
2015,Vratsa,Mizia,2896,1453,1443,43.6867,23.8458
2015,Vratsa,Oryahovo,4592,2251,2341,43.7358,23.9619
2015,Vratsa,Roman,2591,1270,1321,43.1369,24.125
2015,Gabrovo,Gabrovo,54950,26520,28430,42.8747,25.3186
2015,Gabrovo,Dryanovo,7017,3367,3650,42.9747,25.4781
2015,Gabrovo,Plachkovtsi,1626,812,814,42.8333,25.4333
2015,Gabrovo,Sevlievo,21200,10314,10886,43.0275,25.1125
2015,Gabrovo,Tryavna,8696,4148,4548,42.8672,25.5008
2015,Dobrich,Balchik,11399,5664,5735,43.4072,28.1672
2015,Dobrich,General Toshevo,6429,3163,3266,43.7,28.0333
2015,Dobrich,Dobrich,86292,41383,44909,43.5667,27.8333
2015,Dobrich,Kavarna,11055,5370,5685,43.4358,28.3386
2015,Dobrich,Tervel,5810,2858,2952,43.7472,27.41
2015,Dobrich,Shabla,3229,1602,1627,43.535,28.5339
2015,Kardzhali,Ardino,3692,1850,1842,41.5833,25.1333
2015,Kardzhali,Dzhebel,3092,1530,1562,41.4933,25.305
2015,Kardzhali,Krumovgrad,4700,2274,2426,41.4667,25.65
2015,Kardzhali,Kardzhali,43031,20516,22515,41.65,25.3667
2015,Kardzhali,Momchilgrad,7669,3776,3893,41.5258,25.4061
2015,Kyustendil,Bobovdol,5270,2803,2467,42.3522,23.0333
2015,Kyustendil,Boboshevo,1207,572,635,42.1461,23.0708
2015,Kyustendil,Dupnitsa,31147,14930,16217,42.2667,23.1167
2015,Kyustendil,Kocherinovo,2174,1033,1141,42.1167,23.0833
2015,Kyustendil,Kyustendil,41380,19887,21493,42.2833,22.6833
2015,Kyustendil,Rila,2275,1102,1173,42.13,23.3869
2015,Kyustendil,Sapareva Banya,3630,1799,1831,42.2889,23.2672
2015,Lovech,Apriltsi,2714,1318,1396,42.85,24.9167
2015,Lovech,Letnitsa,2534,1255,1279,43.2558,25.0639
2015,Lovech,Lovech,34002,16595,17407,43.1333,24.7167
2015,Lovech,Lukovit,8621,4238,4383,43.2,24.1667
2015,Lovech,Teteven,9116,4447,4669,42.9167,24.2667
2015,Lovech,Troyan,20040,9651,10389,42.89,24.7133
2015,Lovech,Ugarchin,2488,1236,1252,43.1,24.3167
2015,Lovech,Yablanitsa,2688,1360,1328,43.05,24.1
2015,Montana,Berkovitsa,12504,6099,6405,43.2392,23.1272
2015,Montana,Boychinovtsi,1322,660,662,43.4683,23.3044
2015,Montana,Brusartsi,1025,499,526,43.7,23.05
2015,Montana,Valchedram,3315,1590,1725,43.715,23.45
2015,Montana,Varshets,5902,2889,3013,43.1981,23.2875
2015,Montana,Lom,20949,10160,10789,43.8139,23.2369
2015,Montana,Montana,40293,19600,20693,43.4125,23.225
2015,Montana,Chiprovtsi,1702,843,859,43.3844,22.8822
2015,Pazardzhik,Batak,2981,1498,1483,41.9442,24.2181
2015,Pazardzhik,Belovo,3595,1748,1847,42.2122,24.015
2015,Pazardzhik,Bratsigovo,3939,1950,1989,42.0128,24.3742
2015,Pazardzhik,Velingrad,21692,10334,11358,42.0278,23.9908
2015,Pazardzhik,Vetren,2943,1464,1479,42.245,24.0894
2015,Pazardzhik,Kostandovo,4079,2028,2051,42.0656,24.0517
2015,Pazardzhik,Pazardzhik,69384,33524,35860,42.1922,24.3331
2015,Pazardzhik,Panagyurishte,16564,8143,8421,42.5,24.1833
2015,Pazardzhik,Peshtera,16337,8002,8335,42.0347,24.2994
2015,Pazardzhik,Rakitovo,7998,3943,4055,41.9878,24.0861
2015,Pazardzhik,Septemvri,7559,3720,3839,42.2167,24.1
2015,Pazardzhik,Strelcha,3886,1855,2031,42.5,24.3167
2015,Pazardzhik,Sarnitsa,3488,1764,1724,41.7858,24.015
2015,Pernik,Batanovtsi,2167,1072,1095,42.5539,23.0325
2015,Pernik,Breznik,3954,1914,2040,42.7394,22.9078
2015,Pernik,Zemen,1595,803,792,42.48,22.7489
2015,Pernik,Pernik,74824,36011,38813,42.6078,23.0375
2015,Pernik,Radomir,13475,6632,6843,42.5453,22.9775
2015,Pernik,Tran,2350,1187,1163,42.8342,22.6519
2015,Pleven,Belene,7602,4122,3480,43.6511,25.1133
2015,Pleven,Gulyantsi,2990,1448,1542,43.6486,24.7125
2015,Pleven,Dolna Mitropolia,2900,1415,1485,43.4667,24.5333
2015,Pleven,Dolni Dabnik,3987,1910,2077,43.4167,24.4333
2015,Pleven,Iskar,2992,1475,1517,43.4608,24.2686
2015,Pleven,Knezha,9770,4795,4975,43.5,24.0833
2015,Pleven,Koynare,3403,1700,1703,43.3667,24.0833
2015,Pleven,Levski,9295,4464,4831,43.4333,25.1333
2015,Pleven,Nikopol,3060,1504,1556,43.7081,24.8983
2015,Pleven,Pleven,99628,47717,51911,43.4167,24.6167
2015,Pleven,Pordim,1927,950,977,43.4167,24.9167
2015,Pleven,Slavyanovo,3701,1817,1884,43.3167,24.8667
2015,Pleven,Trastenik,4123,2027,2096,43.4833,24.55
2015,Pleven,Cherven Bryag,11842,5871,5971,43.2667,24.1
2015,Plovdiv,Asenovgrad,49510,23814,25696,42.0167,24.8667
2015,Plovdiv,Banya,3309,1542,1767,42.5,24.8333
2015,Plovdiv,Brezovo,1774,887,887,42.4833,25.0833
2015,Plovdiv,Kalofer,2861,1327,1534,42.6178,24.98
2015,Plovdiv,Karlovo,21904,10501,11403,42.6333,24.8
2015,Plovdiv,Klisura,1001,472,529,42.7,24.45
2015,Plovdiv,Krichim,8135,4014,4121,42.0333,24.4667
2015,Plovdiv,Kuklen,5805,2831,2974,42.0333,24.7833
2015,Plovdiv,Laki,1971,998,973,41.8167,24.8333
2015,Plovdiv,Perushtitsa,4917,2409,2508,42.0333,24.55
2015,Plovdiv,Plovdiv,341625,162560,179065,42.15,24.75
2015,Plovdiv,Parvomay,12533,5967,6566,42.1,25.2167
2015,Plovdiv,Rakovski,14846,7196,7650,42.2833,24.9333
2015,Plovdiv,Sadovo,2506,1261,1245,42.1333,24.8667
2015,Plovdiv,Sopot,8353,4025,4328,42.6667,24.75
2015,Plovdiv,Stamboliyski,11080,5353,5727,42.1333,24.5333
2015,Plovdiv,Saedinenie,5519,2707,2812,42.25,24.6
2015,Plovdiv,Hisarya,6689,3165,3524,42.5,24.7
2015,Razgrad,Zavet,2858,1421,1437,43.7333,26.5833
2015,Razgrad,Isperih,8354,4072,4282,43.7167,26.8333
2015,Razgrad,Kubrat,6723,3206,3517,43.8,26.5
2015,Razgrad,Loznitsa,2131,1046,1085,43.4333,26.6167
2015,Razgrad,Razgrad,31739,15011,16728,43.5333,26.5167
2015,Razgrad,Tsar Kaloyan,3455,1697,1758,43.6333,26.2333
2015,Ruse,Borovo,1882,933,949,43.5667,25.8167
2015,Ruse,Byala,7831,3841,3990,42.8833,27.8833
2015,Ruse,Byala,7831,3841,3990,43.4631,25.7214
2015,Ruse,Vetovo,4265,2148,2117,43.7,26.2667
2015,Ruse,Glodzhevo,3235,1620,1615,43.6833,26.5
2015,Ruse,Dve Mogili,3968,1967,2001,43.5,25.8833
2015,Ruse,Marten,3483,1755,1728,43.85,25.9333
2015,Ruse,Ruse,145765,70758,75007,43.8486,25.9534
2015,Ruse,Senovo,1320,652,668,43.6167,26.3167
2015,Ruse,Slivo pole,2904,1437,1467,43.85,26.2
2015,Ruse,Silistra,50306,24226,26080,44.1167,27.2667
2015,Ruse,Silistra,50306,24226,26080,44.1167,27.2667
2015,Ruse,Alfatar,1478,724,754,43.95,27.3
2015,Ruse,Glavinitsa,1435,686,749,43.9333,26.8333
2015,Ruse,Dulovo,6412,3133,3279,43.8333,27.1333
2015,Ruse,Silistra,32868,15723,17145,44.1167,27.2667
2015,Ruse,Silistra,32868,15723,17145,44.1167,27.2667
2015,Ruse,Tutrakan,8113,3960,4153,44.05,26.6167
2015,Sliven,Kermen,1600,809,791,42.6333,26.1333
2015,Sliven,Kotel,5370,2558,2812,42.8833,26.45
2015,Sliven,Nova Zagora,21440,10407,11033,42.4833,26.0167
2015,Sliven,Sliven,87895,42099,45796,42.6833,26.3167
2015,Sliven,Tvarditsa,5671,2885,2786,42.7167,26.0167
2015,Sliven,Shivachevo,3609,1791,1818,42.7,26.0667
2015,Smolyan,Devin,6347,3031,3316,41.7444,24.3978
2015,Smolyan,Dospat,2246,1095,1151,41.6436,24.1667
2015,Smolyan,Zlatograd,6601,3124,3477,41.3833,25.1
2015,Smolyan,Madan,5535,2765,2770,41.4833,24.9333
2015,Smolyan,Nedelino,4088,1992,2096,41.5167,25.1
2015,Smolyan,Rudozem,3525,1731,1794,41.4833,24.85
2015,Smolyan,Smolyan,28591,13717,14874,41.5739,24.7128
2015,Smolyan,Chepelare,5020,2457,2563,41.7269,24.6833
2015,Sofia (stolitsa),Bankya,11245,5474,5771,42.6983,23.1342
2015,Sofia (stolitsa),Buhovo,2639,1308,1331,42.7667,23.4667
2015,Sofia (stolitsa),Novi Iskar,14255,6970,7285,42.8022,23.3006
2015,Sofia (stolitsa),Sofia,1231981,587879,644102,42.6977,23.3219
2015,Sofia (oblast),Bozhurishte,5613,2732,2881,42.755,23.1897
2015,Sofia (oblast),Botevgrad,19594,9470,10124,42.9119,23.8106
2015,Sofia (oblast),Godech,4116,2043,2073,43.0122,23.0447
2015,Sofia (oblast),Dolna Banya,4547,2234,2313,42.3,23.7833
2015,Sofia (oblast),Dragoman,3243,1570,1673,42.9225,23.0464
2015,Sofia (oblast),Elin Pelin,6843,3316,3527,42.6667,23.6
2015,Sofia (oblast),Etropole,9957,4976,4981,42.8333,24.0
2015,Sofia (oblast),Zlatitsa,4752,2319,2433,42.7,24.1333
2015,Sofia (oblast),Ihtiman,12833,6351,6482,42.4333,23.8167
2015,Sofia (oblast),Koprivshtitsa,2174,1067,1107,42.6333,24.35
2015,Sofia (oblast),Kostenets,6291,3068,3223,42.3086,23.8578
2015,Sofia (oblast),Kostinbrod,11661,5688,5973,42.8136,23.2178
2015,Sofia (oblast),Momin prohod,1484,700,784,42.4,23.85
2015,Sofia (oblast),Pirdop,7011,3407,3604,42.7,24.1833
2015,Sofia (oblast),Pravets,3698,1859,1839,42.8986,23.9142
2015,Sofia (oblast),Samokov,25610,12352,13258,42.3378,23.5528
2015,Sofia (oblast),Svoge,7746,3847,3899,42.9597,23.3408
2015,Sofia (oblast),Slivnitsa,7273,3636,3637,42.8511,23.0356
2015,Stara Zagora,Gurkovo,2707,1372,1335,42.65,25.8167
2015,Stara Zagora,Galabovo,7781,3940,3841,42.1333,25.8667
2015,Stara Zagora,Kazanlak,45367,21714,23653,42.6167,25.4
2015,Stara Zagora,Kran,3243,1612,1631,42.6658,25.3738
2015,Stara Zagora,Maglizh,3163,1573,1590,42.6167,25.5667
2015,Stara Zagora,Nikolaevo,2725,1325,1400,42.6833,25.85
2015,Stara Zagora,Pavel Banya,2589,1222,1367,42.6167,25.2
2015,Stara Zagora,Radnevo,12013,5963,6050,42.3,25.9333
2015,Stara Zagora,Stara Zagora,136807,65790,71017,42.4258,25.6347
2015,Stara Zagora,Chirpan,14521,7099,7422,42.2,25.3333
2015,Stara Zagora,Shipka,1215,581,634,42.7167,25.3333
2015,Targovishte,Antonovo,1473,736,737,43.15,26.1667
2015,Targovishte,Omurtag,7291,3429,3862,43.1,26.4167
2015,Targovishte,Opaka,2620,1306,1314,43.45,26.1667
2015,Targovishte,Popovo,14589,7003,7586,43.35,26.2333
2015,Targovishte,Targovishte,35841,17131,18710,43.25,26.5833
2015,Haskovo,Dimitrovgrad,35504,17175,18329,42.0519,25.5897
2015,Haskovo,Ivaylovgrad,3469,1734,1735,41.5283,26.1256
2015,Haskovo,Lyubimets,7159,3557,3602,41.8333,26.0833
2015,Haskovo,Madzharovo,601,299,302,41.6292,25.8667
2015,Haskovo,Merichleri,1560,761,799,42.0,25.8
2015,Haskovo,Svilengrad,17882,8849,9033,41.7667,26.2
2015,Haskovo,Simeonovgrad,6255,3079,3176,42.0333,25.8333
2015,Haskovo,Topolovgrad,5088,2521,2567,42.0844,26.3386
2015,Haskovo,Harmanli,20413,10337,10076,41.9333,25.9
2015,Haskovo,Haskovo,72336,34536,37800,41.9333,25.5667
2015,Shumen,Veliki Preslav,7345,3577,3768,43.1667,26.8167
2015,Shumen,Varbitsa,3294,1609,1685,43.1667,26.5833
2015,Shumen,Kaolinovo,1477,752,725,43.3167,27.0167
2015,Shumen,Kaspichan,2863,1410,1453,43.3167,27.1667
2015,Shumen,Novi Pazar,11564,5594,5970,43.35,27.2
2015,Shumen,Pliska,890,426,464,43.3667,27.1167
2015,Shumen,Smyadovo,3623,1785,1838,43.0333,27.05
2015,Shumen,Shumen,77709,37197,40512,43.2714,26.9361
2015,Yambol,Bolyarovo,1139,559,580,42.1,26.8333
2015,Yambol,Elhovo,9786,4781,5005,42.1667,26.5667
2015,Yambol,Straldzha,5668,2829,2839,42.6,26.6833
2015,Yambol,Yambol,70224,34117,36107,42.4833,26.5
2016,Blagoevgrad,Bansko,8881,4338,4543,41.8383,23.488
2016,Blagoevgrad,Belitsa,3107,1492,1615,41.9494,23.5725
2016,Blagoevgrad,Blagoevgrad,69567,32951,36616,42.0167,23.1
2016,Blagoevgrad,Gotse Delchev,18552,8839,9713,41.5667,23.7333
2016,Blagoevgrad,Dobrinishte,2688,1311,1377,41.825,23.5594
2016,Blagoevgrad,Kresna,3425,1731,1694,41.73,23.1569
2016,Blagoevgrad,Melnik,199,98,101,41.5231,23.3925
2016,Blagoevgrad,Petrich,27587,13212,14375,41.3981,23.2072
2016,Blagoevgrad,Razlog,11590,5588,6002,41.8864,23.4678
2016,Blagoevgrad,Sandanski,25054,12034,13020,41.5667,23.2833
2016,Blagoevgrad,Simitli,6486,3239,3247,41.8936,23.1069
2016,Blagoevgrad,Hadzhidimovo,2539,1291,1248,41.5167,23.8667
2016,Blagoevgrad,Yakoruda,5385,2575,2810,42.02,23.6833
2016,Burgas,Aytos,19490,9410,10080,42.7,27.25
2016,Burgas,Aheloy,2310,1169,1141,42.6483,27.6494
2016,Burgas,Ahtopol,1283,632,651,42.1,27.95
2016,Burgas,Burgas,202766,96717,106049,42.4975,27.47
2016,Burgas,Bulgarovo,1581,791,790,42.65,27.3333
2016,Burgas,Kableshkovo,2888,1422,1466,42.6167,27.5667
2016,Burgas,Kameno,4185,2067,2118,42.5667,27.3667
2016,Burgas,Karnobat,17472,8487,8985,42.65,26.9833
2016,Burgas,Kiten,947,471,476,42.2344,27.7711
2016,Burgas,Malko Tarnovo,2139,1071,1068,41.9833,27.5333
2016,Burgas,Nesebar,12548,6030,6518,42.66,27.72
2016,Burgas,Obzor,2442,1245,1197,42.8167,27.8833
2016,Burgas,Pomorie,13607,6512,7095,42.55,27.65
2016,Burgas,Primorsko,2966,1482,1484,42.2667,27.75
2016,Burgas,Sveti Vlas,3714,1881,1833,42.7167,27.7667
2016,Burgas,Sozopol,4342,2111,2231,42.4167,27.7
2016,Burgas,Sredets,8759,4316,4443,42.3483,27.1933
2016,Burgas,Sungurlare,2998,1488,1510,42.7667,26.7833
2016,Burgas,Tsarevo,5935,2918,3017,42.17,27.85
2016,Burgas,Chernomorets,2125,1058,1067,42.45,27.64
2016,Varna,Aksakovo,7865,3858,4007,43.2592,27.8211
2016,Varna,Beloslav,7483,3736,3747,43.19,27.7
2016,Varna,Byala,2102,1066,1036,42.8833,27.8833
2016,Varna,Byala,2102,1066,1036,43.4631,25.7214
2016,Varna,Varna,335177,162170,173007,43.2167,27.9167
2016,Varna,Valchi Dol,2962,1444,1518,43.4,27.5333
2016,Varna,Devnya,7898,3915,3983,43.2222,27.57
2016,Varna,Dolni Chiflik,6471,3207,3264,42.9833,27.7333
2016,Varna,Dalgopol,4506,2259,2247,43.05,27.35
2016,Varna,Ignatievo,4004,1949,2055,43.3,27.7
2016,Varna,Provadia,12151,5985,6166,43.1833,27.4333
2016,Varna,Suvorovo,4546,2257,2289,43.33,27.6
2016,Veliko Tarnovo,Byala Cherkva,1727,851,876,43.15,25.3
2016,Veliko Tarnovo,Veliko Tarnovo,68478,32611,35867,43.0833,25.65
2016,Veliko Tarnovo,Gorna Oryahovitsa,29478,14205,15273,43.1278,25.7019
2016,Veliko Tarnovo,Debelets,3860,1884,1976,43.0333,25.6167
2016,Veliko Tarnovo,Dolna Oryahovitsa,2689,1303,1386,43.1167,25.7833
2016,Veliko Tarnovo,Elena,5054,2414,2640,42.9333,25.8833
2016,Veliko Tarnovo,Zlataritsa,2101,1044,1057,43.05,25.9
2016,Veliko Tarnovo,Kilifarevo,2131,1033,1098,42.9833,25.6333
2016,Veliko Tarnovo,Lyaskovets,7713,3666,4047,43.1111,25.7261
2016,Veliko Tarnovo,Pavlikeni,9735,4702,5033,43.2428,25.3219
2016,Veliko Tarnovo,Polski Trambesh,4015,1997,2018,43.3667,25.65
2016,Veliko Tarnovo,Svishtov,26869,12983,13886,43.6239,25.3531
2016,Veliko Tarnovo,Strazhitsa,4322,2134,2188,43.2333,25.9667
2016,Veliko Tarnovo,Suhindol,1697,836,861,43.1833,25.2
2016,Vidin,Belogradchik,4694,2318,2376,43.6278,22.6833
2016,Vidin,Bregovo,2291,1102,1189,44.15,22.65
2016,Vidin,Vidin,42801,20759,22042,43.99,22.8725
2016,Vidin,Gramada,1366,691,675,43.8742,22.6783
2016,Vidin,Dimovo,1071,521,550,43.7417,22.7283
2016,Vidin,Dunavtsi,1975,961,1014,44.0,22.8667
2016,Vidin,Kula,2720,1328,1392,43.89,22.5217
2016,Vratsa,Byala Slatina,10200,4947,5253,43.4667,23.9333
2016,Vratsa,Vratsa,53570,25894,27676,43.21,23.5625
2016,Vratsa,Kozloduy,12235,6044,6191,43.7833,23.7333
2016,Vratsa,Krivodol,2719,1341,1378,43.3683,23.4936
2016,Vratsa,Mezdra,9547,4600,4947,43.15,23.7
2016,Vratsa,Mizia,2803,1408,1395,43.6867,23.8458
2016,Vratsa,Oryahovo,4495,2199,2296,43.7358,23.9619
2016,Vratsa,Roman,2570,1258,1312,43.1369,24.125
2016,Gabrovo,Gabrovo,54004,26040,27964,42.8747,25.3186
2016,Gabrovo,Dryanovo,6887,3295,3592,42.9747,25.4781
2016,Gabrovo,Plachkovtsi,1572,783,789,42.8333,25.4333
2016,Gabrovo,Sevlievo,20898,10164,10734,43.0275,25.1125
2016,Gabrovo,Tryavna,8543,4060,4483,42.8672,25.5008
2016,Dobrich,Balchik,11328,5594,5734,43.4072,28.1672
2016,Dobrich,General Toshevo,6344,3094,3250,43.7,28.0333
2016,Dobrich,Dobrich,85402,40895,44507,43.5667,27.8333
2016,Dobrich,Kavarna,10982,5314,5668,43.4358,28.3386
2016,Dobrich,Tervel,5781,2841,2940,43.7472,27.41
2016,Dobrich,Shabla,3214,1590,1624,43.535,28.5339
2016,Kardzhali,Ardino,3799,1910,1889,41.5833,25.1333
2016,Kardzhali,Dzhebel,3101,1529,1572,41.4933,25.305
2016,Kardzhali,Krumovgrad,4631,2242,2389,41.4667,25.65
2016,Kardzhali,Kardzhali,43022,20496,22526,41.65,25.3667
2016,Kardzhali,Momchilgrad,7639,3782,3857,41.5258,25.4061
2016,Kyustendil,Bobovdol,5177,2744,2433,42.3522,23.0333
2016,Kyustendil,Boboshevo,1166,547,619,42.1461,23.0708
2016,Kyustendil,Dupnitsa,30627,14629,15998,42.2667,23.1167
2016,Kyustendil,Kocherinovo,2130,1008,1122,42.1167,23.0833
2016,Kyustendil,Kyustendil,40682,19550,21132,42.2833,22.6833
2016,Kyustendil,Rila,2217,1081,1136,42.13,23.3869
2016,Kyustendil,Sapareva Banya,3595,1785,1810,42.2889,23.2672
2016,Lovech,Apriltsi,2623,1268,1355,42.85,24.9167
2016,Lovech,Letnitsa,2479,1219,1260,43.2558,25.0639
2016,Lovech,Lovech,33426,16268,17158,43.1333,24.7167
2016,Lovech,Lukovit,8519,4181,4338,43.2,24.1667
2016,Lovech,Teteven,8990,4388,4602,42.9167,24.2667
2016,Lovech,Troyan,19785,9518,10267,42.89,24.7133
2016,Lovech,Ugarchin,2448,1217,1231,43.1,24.3167
2016,Lovech,Yablanitsa,2681,1355,1326,43.05,24.1
2016,Montana,Berkovitsa,12360,6028,6332,43.2392,23.1272
2016,Montana,Boychinovtsi,1323,656,667,43.4683,23.3044
2016,Montana,Brusartsi,1012,492,520,43.7,23.05
2016,Montana,Valchedram,3238,1539,1699,43.715,23.45
2016,Montana,Varshets,5816,2838,2978,43.1981,23.2875
2016,Montana,Lom,20508,9918,10590,43.8139,23.2369
2016,Montana,Montana,39838,19312,20526,43.4125,23.225
2016,Montana,Chiprovtsi,1656,822,834,43.3844,22.8822
2016,Pazardzhik,Batak,2924,1478,1446,41.9442,24.2181
2016,Pazardzhik,Belovo,3530,1722,1808,42.2122,24.015
2016,Pazardzhik,Bratsigovo,3870,1913,1957,42.0128,24.3742
2016,Pazardzhik,Velingrad,21558,10284,11274,42.0278,23.9908
2016,Pazardzhik,Vetren,2886,1429,1457,42.245,24.0894
2016,Pazardzhik,Kostandovo,4063,2015,2048,42.0656,24.0517
2016,Pazardzhik,Pazardzhik,68963,33303,35660,42.1922,24.3331
2016,Pazardzhik,Panagyurishte,16359,8042,8317,42.5,24.1833
2016,Pazardzhik,Peshtera,16189,7931,8258,42.0347,24.2994
2016,Pazardzhik,Rakitovo,7974,3917,4057,41.9878,24.0861
2016,Pazardzhik,Septemvri,7485,3678,3807,42.2167,24.1
2016,Pazardzhik,Strelcha,3821,1817,2004,42.5,24.3167
2016,Pazardzhik,Sarnitsa,3452,1739,1713,41.7858,24.015
2016,Pernik,Batanovtsi,2134,1058,1076,42.5539,23.0325
2016,Pernik,Breznik,3935,1899,2036,42.7394,22.9078
2016,Pernik,Zemen,1543,775,768,42.48,22.7489
2016,Pernik,Pernik,74110,35651,38459,42.6078,23.0375
2016,Pernik,Radomir,13279,6536,6743,42.5453,22.9775
2016,Pernik,Tran,2315,1160,1155,42.8342,22.6519
2016,Pleven,Belene,7449,4028,3421,43.6511,25.1133
2016,Pleven,Gulyantsi,2988,1451,1537,43.6486,24.7125
2016,Pleven,Dolna Mitropolia,2871,1403,1468,43.4667,24.5333
2016,Pleven,Dolni Dabnik,3927,1879,2048,43.4167,24.4333
2016,Pleven,Iskar,2939,1449,1490,43.4608,24.2686
2016,Pleven,Knezha,9665,4725,4940,43.5,24.0833
2016,Pleven,Koynare,3359,1670,1689,43.3667,24.0833
2016,Pleven,Levski,9148,4377,4771,43.4333,25.1333
2016,Pleven,Nikopol,2994,1469,1525,43.7081,24.8983
2016,Pleven,Pleven,98467,47083,51384,43.4167,24.6167
2016,Pleven,Pordim,1889,938,951,43.4167,24.9167
2016,Pleven,Slavyanovo,3674,1802,1872,43.3167,24.8667
2016,Pleven,Trastenik,4072,2004,2068,43.4833,24.55
2016,Pleven,Cherven Bryag,11618,5749,5869,43.2667,24.1
2016,Plovdiv,Asenovgrad,49250,23690,25560,42.0167,24.8667
2016,Plovdiv,Banya,3259,1515,1744,42.5,24.8333
2016,Plovdiv,Brezovo,1734,874,860,42.4833,25.0833
2016,Plovdiv,Kalofer,2846,1320,1526,42.6178,24.98
2016,Plovdiv,Karlovo,21612,10337,11275,42.6333,24.8
2016,Plovdiv,Klisura,966,453,513,42.7,24.45
2016,Plovdiv,Krichim,8077,3978,4099,42.0333,24.4667
2016,Plovdiv,Kuklen,5770,2812,2958,42.0333,24.7833
2016,Plovdiv,Laki,1918,970,948,41.8167,24.8333
2016,Plovdiv,Perushtitsa,4851,2378,2473,42.0333,24.55
2016,Plovdiv,Plovdiv,343424,163208,180216,42.15,24.75
2016,Plovdiv,Parvomay,12371,5865,6506,42.1,25.2167
2016,Plovdiv,Rakovski,14799,7180,7619,42.2833,24.9333
2016,Plovdiv,Sadovo,2476,1251,1225,42.1333,24.8667
2016,Plovdiv,Sopot,8284,3981,4303,42.6667,24.75
2016,Plovdiv,Stamboliyski,10994,5318,5676,42.1333,24.5333
2016,Plovdiv,Saedinenie,5502,2683,2819,42.25,24.6
2016,Plovdiv,Hisarya,6574,3114,3460,42.5,24.7
2016,Razgrad,Zavet,2802,1389,1413,43.7333,26.5833
2016,Razgrad,Isperih,8253,4015,4238,43.7167,26.8333
2016,Razgrad,Kubrat,6597,3142,3455,43.8,26.5
2016,Razgrad,Loznitsa,2102,1030,1072,43.4333,26.6167
2016,Razgrad,Razgrad,31301,14812,16489,43.5333,26.5167
2016,Razgrad,Tsar Kaloyan,3377,1658,1719,43.6333,26.2333
2016,Ruse,Borovo,1836,911,925,43.5667,25.8167
2016,Ruse,Byala,7705,3765,3940,42.8833,27.8833
2016,Ruse,Byala,7705,3765,3940,43.4631,25.7214
2016,Ruse,Vetovo,4241,2127,2114,43.7,26.2667
2016,Ruse,Glodzhevo,3218,1614,1604,43.6833,26.5
2016,Ruse,Dve Mogili,3927,1946,1981,43.5,25.8833
2016,Ruse,Marten,3461,1736,1725,43.85,25.9333
2016,Ruse,Ruse,144936,70367,74569,43.8486,25.9534
2016,Ruse,Senovo,1286,640,646,43.6167,26.3167
2016,Ruse,Slivo pole,2895,1440,1455,43.85,26.2
2016,Ruse,Silistra,49620,23818,25802,44.1167,27.2667
2016,Ruse,Silistra,49620,23818,25802,44.1167,27.2667
2016,Ruse,Alfatar,1437,702,735,43.95,27.3
2016,Ruse,Glavinitsa,1393,659,734,43.9333,26.8333
2016,Ruse,Dulovo,6392,3092,3300,43.8333,27.1333
2016,Ruse,Silistra,32400,15461,16939,44.1167,27.2667
2016,Ruse,Silistra,32400,15461,16939,44.1167,27.2667
2016,Ruse,Tutrakan,7998,3904,4094,44.05,26.6167
2016,Sliven,Kermen,1569,793,776,42.6333,26.1333
2016,Sliven,Kotel,5329,2541,2788,42.8833,26.45
2016,Sliven,Nova Zagora,21270,10310,10960,42.4833,26.0167
2016,Sliven,Sliven,87322,41783,45539,42.6833,26.3167
2016,Sliven,Tvarditsa,5681,2872,2809,42.7167,26.0167
2016,Sliven,Shivachevo,3627,1813,1814,42.7,26.0667
2016,Smolyan,Devin,6223,2950,3273,41.7444,24.3978
2016,Smolyan,Dospat,2191,1070,1121,41.6436,24.1667
2016,Smolyan,Zlatograd,6514,3096,3418,41.3833,25.1
2016,Smolyan,Madan,5455,2731,2724,41.4833,24.9333
2016,Smolyan,Nedelino,3978,1942,2036,41.5167,25.1
2016,Smolyan,Rudozem,3462,1706,1756,41.4833,24.85
2016,Smolyan,Smolyan,28160,13489,14671,41.5739,24.7128
2016,Smolyan,Chepelare,4944,2430,2514,41.7269,24.6833
2016,Sofia (stolitsa),Bankya,11234,5491,5743,42.6983,23.1342
2016,Sofia (stolitsa),Buhovo,2624,1311,1313,42.7667,23.4667
2016,Sofia (stolitsa),Novi Iskar,14159,6937,7222,42.8022,23.3006
2016,Sofia (stolitsa),Sofia,1236047,590336,645711,42.6977,23.3219
2016,Sofia (oblast),Bozhurishte,5543,2701,2842,42.755,23.1897
2016,Sofia (oblast),Botevgrad,19456,9373,10083,42.9119,23.8106
2016,Sofia (oblast),Godech,4039,2005,2034,43.0122,23.0447
2016,Sofia (oblast),Dolna Banya,4531,2221,2310,42.3,23.7833
2016,Sofia (oblast),Dragoman,3161,1530,1631,42.9225,23.0464
2016,Sofia (oblast),Elin Pelin,6884,3331,3553,42.6667,23.6
2016,Sofia (oblast),Etropole,9849,4939,4910,42.8333,24.0
2016,Sofia (oblast),Zlatitsa,4687,2280,2407,42.7,24.1333
2016,Sofia (oblast),Ihtiman,12723,6309,6414,42.4333,23.8167
2016,Sofia (oblast),Koprivshtitsa,2135,1043,1092,42.6333,24.35
2016,Sofia (oblast),Kostenets,6202,3024,3178,42.3086,23.8578
2016,Sofia (oblast),Kostinbrod,11546,5642,5904,42.8136,23.2178
2016,Sofia (oblast),Momin prohod,1462,686,776,42.4,23.85
2016,Sofia (oblast),Pirdop,6919,3342,3577,42.7,24.1833
2016,Sofia (oblast),Pravets,3636,1818,1818,42.8986,23.9142
2016,Sofia (oblast),Samokov,25382,12237,13145,42.3378,23.5528
2016,Sofia (oblast),Svoge,7666,3811,3855,42.9597,23.3408
2016,Sofia (oblast),Slivnitsa,7159,3576,3583,42.8511,23.0356
2016,Stara Zagora,Gurkovo,2722,1387,1335,42.65,25.8167
2016,Stara Zagora,Galabovo,7613,3851,3762,42.1333,25.8667
2016,Stara Zagora,Kazanlak,45076,21560,23516,42.6167,25.4
2016,Stara Zagora,Kran,3228,1600,1628,42.6658,25.3738
2016,Stara Zagora,Maglizh,3128,1562,1566,42.6167,25.5667
2016,Stara Zagora,Nikolaevo,2728,1336,1392,42.6833,25.85
2016,Stara Zagora,Pavel Banya,2554,1203,1351,42.6167,25.2
2016,Stara Zagora,Radnevo,11847,5881,5966,42.3,25.9333
2016,Stara Zagora,Stara Zagora,136781,65636,71145,42.4258,25.6347
2016,Stara Zagora,Chirpan,14377,7027,7350,42.2,25.3333
2016,Stara Zagora,Shipka,1189,566,623,42.7167,25.3333
2016,Targovishte,Antonovo,1455,723,732,43.15,26.1667
2016,Targovishte,Omurtag,7263,3402,3861,43.1,26.4167
2016,Targovishte,Opaka,2547,1270,1277,43.45,26.1667
2016,Targovishte,Popovo,14411,6915,7496,43.35,26.2333
2016,Targovishte,Targovishte,35536,17000,18536,43.25,26.5833
2016,Haskovo,Dimitrovgrad,35074,16909,18165,42.0519,25.5897
2016,Haskovo,Ivaylovgrad,3385,1698,1687,41.5283,26.1256
2016,Haskovo,Lyubimets,7071,3516,3555,41.8333,26.0833
2016,Haskovo,Madzharovo,587,295,292,41.6292,25.8667
2016,Haskovo,Merichleri,1541,748,793,42.0,25.8
2016,Haskovo,Svilengrad,17754,8778,8976,41.7667,26.2
2016,Haskovo,Simeonovgrad,6226,3062,3164,42.0333,25.8333
2016,Haskovo,Topolovgrad,4986,2442,2544,42.0844,26.3386
2016,Haskovo,Harmanli,20216,10230,9986,41.9333,25.9
2016,Haskovo,Haskovo,71686,34189,37497,41.9333,25.5667
2016,Shumen,Veliki Preslav,7275,3550,3725,43.1667,26.8167
2016,Shumen,Varbitsa,3300,1613,1687,43.1667,26.5833
2016,Shumen,Kaolinovo,1501,768,733,43.3167,27.0167
2016,Shumen,Kaspichan,2833,1385,1448,43.3167,27.1667
2016,Shumen,Novi Pazar,11520,5596,5924,43.35,27.2
2016,Shumen,Pliska,853,405,448,43.3667,27.1167
2016,Shumen,Smyadovo,3601,1771,1830,43.0333,27.05
2016,Shumen,Shumen,76967,36869,40098,43.2714,26.9361
2016,Yambol,Bolyarovo,1132,561,571,42.1,26.8333
2016,Yambol,Elhovo,9618,4681,4937,42.1667,26.5667
2016,Yambol,Straldzha,5688,2864,2824,42.6,26.6833
2016,Yambol,Yambol,69542,33750,35792,42.4833,26.5
2017,Blagoevgrad,Bansko,9049,4412,4637,41.8383,23.488
2017,Blagoevgrad,Belitsa,3055,1475,1580,41.9494,23.5725
2017,Blagoevgrad,Blagoevgrad,69417,32851,36566,42.0167,23.1
2017,Blagoevgrad,Gotse Delchev,18433,8770,9663,41.5667,23.7333
2017,Blagoevgrad,Dobrinishte,2657,1293,1364,41.825,23.5594
2017,Blagoevgrad,Kresna,3365,1710,1655,41.73,23.1569
2017,Blagoevgrad,Melnik,189,97,92,41.5231,23.3925
2017,Blagoevgrad,Petrich,27211,13000,14211,41.3981,23.2072
2017,Blagoevgrad,Razlog,11592,5586,6006,41.8864,23.4678
2017,Blagoevgrad,Sandanski,24968,11943,13025,41.5667,23.2833
2017,Blagoevgrad,Simitli,6454,3228,3226,41.8936,23.1069
2017,Blagoevgrad,Hadzhidimovo,2508,1274,1234,41.5167,23.8667
2017,Blagoevgrad,Yakoruda,5317,2549,2768,42.02,23.6833
2017,Burgas,Aytos,19443,9367,10076,42.7,27.25
2017,Burgas,Aheloy,2276,1161,1115,42.6483,27.6494
2017,Burgas,Ahtopol,1254,623,631,42.1,27.95
2017,Burgas,Burgas,202694,96488,106206,42.4975,27.47
2017,Burgas,Bulgarovo,1556,778,778,42.65,27.3333
2017,Burgas,Kableshkovo,2877,1421,1456,42.6167,27.5667
2017,Burgas,Kameno,4195,2053,2142,42.5667,27.3667
2017,Burgas,Karnobat,17353,8446,8907,42.65,26.9833
2017,Burgas,Kiten,925,458,467,42.2344,27.7711
2017,Burgas,Malko Tarnovo,2099,1058,1041,41.9833,27.5333
2017,Burgas,Nesebar,12749,6103,6646,42.66,27.72
2017,Burgas,Obzor,2372,1209,1163,42.8167,27.8833
2017,Burgas,Pomorie,13625,6483,7142,42.55,27.65
2017,Burgas,Primorsko,2940,1468,1472,42.2667,27.75
2017,Burgas,Sveti Vlas,3693,1861,1832,42.7167,27.7667
2017,Burgas,Sozopol,4330,2097,2233,42.4167,27.7
2017,Burgas,Sredets,8699,4292,4407,42.3483,27.1933
2017,Burgas,Sungurlare,2974,1461,1513,42.7667,26.7833
2017,Burgas,Tsarevo,5876,2877,2999,42.17,27.85
2017,Burgas,Chernomorets,2106,1043,1063,42.45,27.64
2017,Varna,Aksakovo,7787,3838,3949,43.2592,27.8211
2017,Varna,Beloslav,7438,3727,3711,43.19,27.7
2017,Varna,Byala,2092,1059,1033,42.8833,27.8833
2017,Varna,Byala,2092,1059,1033,43.4631,25.7214
2017,Varna,Varna,335854,162365,173489,43.2167,27.9167
2017,Varna,Valchi Dol,2907,1411,1496,43.4,27.5333
2017,Varna,Devnya,7827,3909,3918,43.2222,27.57
2017,Varna,Dolni Chiflik,6451,3194,3257,42.9833,27.7333
2017,Varna,Dalgopol,4470,2236,2234,43.05,27.35
2017,Varna,Ignatievo,3978,1935,2043,43.3,27.7
2017,Varna,Provadia,12164,5975,6189,43.1833,27.4333
2017,Varna,Suvorovo,4520,2250,2270,43.33,27.6
2017,Veliko Tarnovo,Byala Cherkva,1697,835,862,43.15,25.3
2017,Veliko Tarnovo,Veliko Tarnovo,68780,32732,36048,43.0833,25.65
2017,Veliko Tarnovo,Gorna Oryahovitsa,29173,14014,15159,43.1278,25.7019
2017,Veliko Tarnovo,Debelets,3831,1876,1955,43.0333,25.6167
2017,Veliko Tarnovo,Dolna Oryahovitsa,2656,1285,1371,43.1167,25.7833
2017,Veliko Tarnovo,Elena,4945,2350,2595,42.9333,25.8833
2017,Veliko Tarnovo,Zlataritsa,2088,1040,1048,43.05,25.9
2017,Veliko Tarnovo,Kilifarevo,2100,1031,1069,42.9833,25.6333
2017,Veliko Tarnovo,Lyaskovets,7574,3603,3971,43.1111,25.7261
2017,Veliko Tarnovo,Pavlikeni,9613,4648,4965,43.2428,25.3219
2017,Veliko Tarnovo,Polski Trambesh,3985,1980,2005,43.3667,25.65
2017,Veliko Tarnovo,Svishtov,26047,12640,13407,43.6239,25.3531
2017,Veliko Tarnovo,Strazhitsa,4279,2102,2177,43.2333,25.9667
2017,Veliko Tarnovo,Suhindol,1660,809,851,43.1833,25.2
2017,Vidin,Belogradchik,4611,2278,2333,43.6278,22.6833
2017,Vidin,Bregovo,2228,1073,1155,44.15,22.65
2017,Vidin,Vidin,42195,20452,21743,43.99,22.8725
2017,Vidin,Gramada,1296,661,635,43.8742,22.6783
2017,Vidin,Dimovo,1057,515,542,43.7417,22.7283
2017,Vidin,Dunavtsi,1916,924,992,44.0,22.8667
2017,Vidin,Kula,2697,1296,1401,43.89,22.5217
2017,Vratsa,Byala Slatina,9987,4841,5146,43.4667,23.9333
2017,Vratsa,Vratsa,53120,25586,27534,43.21,23.5625
2017,Vratsa,Kozloduy,12009,5933,6076,43.7833,23.7333
2017,Vratsa,Krivodol,2676,1313,1363,43.3683,23.4936
2017,Vratsa,Mezdra,9428,4538,4890,43.15,23.7
2017,Vratsa,Mizia,2727,1372,1355,43.6867,23.8458
2017,Vratsa,Oryahovo,4401,2163,2238,43.7358,23.9619
2017,Vratsa,Roman,2559,1247,1312,43.1369,24.125
2017,Gabrovo,Gabrovo,53063,25580,27483,42.8747,25.3186
2017,Gabrovo,Dryanovo,6723,3221,3502,42.9747,25.4781
2017,Gabrovo,Plachkovtsi,1519,761,758,42.8333,25.4333
2017,Gabrovo,Sevlievo,20654,10039,10615,43.0275,25.1125
2017,Gabrovo,Tryavna,8328,3962,4366,42.8672,25.5008
2017,Dobrich,Balchik,11232,5514,5718,43.4072,28.1672
2017,Dobrich,General Toshevo,6258,3057,3201,43.7,28.0333
2017,Dobrich,Dobrich,84502,40338,44164,43.5667,27.8333
2017,Dobrich,Kavarna,10873,5264,5609,43.4358,28.3386
2017,Dobrich,Tervel,5672,2784,2888,43.7472,27.41
2017,Dobrich,Shabla,3129,1552,1577,43.535,28.5339
2017,Kardzhali,Ardino,3919,1963,1956,41.5833,25.1333
2017,Kardzhali,Dzhebel,3137,1553,1584,41.4933,25.305
2017,Kardzhali,Krumovgrad,4678,2269,2409,41.4667,25.65
2017,Kardzhali,Kardzhali,43182,20567,22615,41.65,25.3667
2017,Kardzhali,Momchilgrad,7681,3769,3912,41.5258,25.4061
2017,Kyustendil,Bobovdol,5061,2671,2390,42.3522,23.0333
2017,Kyustendil,Boboshevo,1124,529,595,42.1461,23.0708
2017,Kyustendil,Dupnitsa,30165,14373,15792,42.2667,23.1167
2017,Kyustendil,Kocherinovo,2064,978,1086,42.1167,23.0833
2017,Kyustendil,Kyustendil,40226,19302,20924,42.2833,22.6833
2017,Kyustendil,Rila,2148,1041,1107,42.13,23.3869
2017,Kyustendil,Sapareva Banya,3541,1756,1785,42.2889,23.2672
2017,Lovech,Apriltsi,2555,1234,1321,42.85,24.9167
2017,Lovech,Letnitsa,2455,1211,1244,43.2558,25.0639
2017,Lovech,Lovech,32818,15902,16916,43.1333,24.7167
2017,Lovech,Lukovit,8416,4125,4291,43.2,24.1667
2017,Lovech,Teteven,8854,4319,4535,42.9167,24.2667
2017,Lovech,Troyan,19605,9419,10186,42.89,24.7133
2017,Lovech,Ugarchin,2400,1196,1204,43.1,24.3167
2017,Lovech,Yablanitsa,2587,1305,1282,43.05,24.1
2017,Montana,Berkovitsa,12171,5937,6234,43.2392,23.1272
2017,Montana,Boychinovtsi,1309,640,669,43.4683,23.3044
2017,Montana,Brusartsi,978,474,504,43.7,23.05
2017,Montana,Valchedram,3158,1498,1660,43.715,23.45
2017,Montana,Varshets,5668,2772,2896,43.1981,23.2875
2017,Montana,Lom,20148,9694,10454,43.8139,23.2369
2017,Montana,Montana,39595,19140,20455,43.4125,23.225
2017,Montana,Chiprovtsi,1594,789,805,43.3844,22.8822
2017,Pazardzhik,Batak,2857,1440,1417,41.9442,24.2181
2017,Pazardzhik,Belovo,3449,1692,1757,42.2122,24.015
2017,Pazardzhik,Bratsigovo,3813,1879,1934,42.0128,24.3742
2017,Pazardzhik,Velingrad,21429,10212,11217,42.0278,23.9908
2017,Pazardzhik,Vetren,2834,1400,1434,42.245,24.0894
2017,Pazardzhik,Kostandovo,4039,2001,2038,42.0656,24.0517
2017,Pazardzhik,Pazardzhik,68572,33054,35518,42.1922,24.3331
2017,Pazardzhik,Panagyurishte,16222,7973,8249,42.5,24.1833
2017,Pazardzhik,Peshtera,15986,7846,8140,42.0347,24.2994
2017,Pazardzhik,Rakitovo,7937,3900,4037,41.9878,24.0861
2017,Pazardzhik,Septemvri,7374,3626,3748,42.2167,24.1
2017,Pazardzhik,Strelcha,3781,1795,1986,42.5,24.3167
2017,Pazardzhik,Sarnitsa,3413,1726,1687,41.7858,24.015
2017,Pernik,Batanovtsi,2105,1039,1066,42.5539,23.0325
2017,Pernik,Breznik,3953,1904,2049,42.7394,22.9078
2017,Pernik,Zemen,1507,761,746,42.48,22.7489
2017,Pernik,Pernik,73638,35325,38313,42.6078,23.0375
2017,Pernik,Radomir,13110,6453,6657,42.5453,22.9775
2017,Pernik,Tran,2334,1167,1167,42.8342,22.6519
2017,Pleven,Belene,7266,3913,3353,43.6511,25.1133
2017,Pleven,Gulyantsi,2943,1433,1510,43.6486,24.7125
2017,Pleven,Dolna Mitropolia,2829,1394,1435,43.4667,24.5333
2017,Pleven,Dolni Dabnik,3879,1853,2026,43.4167,24.4333
2017,Pleven,Iskar,2893,1425,1468,43.4608,24.2686
2017,Pleven,Knezha,9479,4619,4860,43.5,24.0833
2017,Pleven,Koynare,3275,1638,1637,43.3667,24.0833
2017,Pleven,Levski,9012,4286,4726,43.4333,25.1333
2017,Pleven,Nikopol,2931,1443,1488,43.7081,24.8983
2017,Pleven,Pleven,97557,46531,51026,43.4167,24.6167
2017,Pleven,Pordim,1867,930,937,43.4167,24.9167
2017,Pleven,Slavyanovo,3591,1760,1831,43.3167,24.8667
2017,Pleven,Trastenik,4052,1999,2053,43.4833,24.55
2017,Pleven,Cherven Bryag,11417,5637,5780,43.2667,24.1
2017,Plovdiv,Asenovgrad,49042,23565,25477,42.0167,24.8667
2017,Plovdiv,Banya,3229,1499,1730,42.5,24.8333
2017,Plovdiv,Brezovo,1695,849,846,42.4833,25.0833
2017,Plovdiv,Kalofer,2792,1293,1499,42.6178,24.98
2017,Plovdiv,Karlovo,21381,10199,11182,42.6333,24.8
2017,Plovdiv,Klisura,948,433,515,42.7,24.45
2017,Plovdiv,Krichim,7991,3923,4068,42.0333,24.4667
2017,Plovdiv,Kuklen,5741,2802,2939,42.0333,24.7833
2017,Plovdiv,Laki,1886,954,932,41.8167,24.8333
2017,Plovdiv,Perushtitsa,4798,2359,2439,42.0333,24.55
2017,Plovdiv,Plovdiv,345213,164094,181119,42.15,24.75
2017,Plovdiv,Parvomay,12327,5849,6478,42.1,25.2167
2017,Plovdiv,Rakovski,14745,7158,7587,42.2833,24.9333
2017,Plovdiv,Sadovo,2452,1229,1223,42.1333,24.8667
2017,Plovdiv,Sopot,8237,3947,4290,42.6667,24.75
2017,Plovdiv,Stamboliyski,10930,5279,5651,42.1333,24.5333
2017,Plovdiv,Saedinenie,5442,2655,2787,42.25,24.6
2017,Plovdiv,Hisarya,6461,3060,3401,42.5,24.7
2017,Razgrad,Zavet,2756,1363,1393,43.7333,26.5833
2017,Razgrad,Isperih,8146,3967,4179,43.7167,26.8333
2017,Razgrad,Kubrat,6488,3094,3394,43.8,26.5
2017,Razgrad,Loznitsa,2077,1020,1057,43.4333,26.6167
2017,Razgrad,Razgrad,30921,14563,16358,43.5333,26.5167
2017,Razgrad,Tsar Kaloyan,3303,1617,1686,43.6333,26.2333
2017,Ruse,Borovo,1795,899,896,43.5667,25.8167
2017,Ruse,Byala,7610,3712,3898,42.8833,27.8833
2017,Ruse,Byala,7610,3712,3898,43.4631,25.7214
2017,Ruse,Vetovo,4200,2125,2075,43.7,26.2667
2017,Ruse,Glodzhevo,3189,1599,1590,43.6833,26.5
2017,Ruse,Dve Mogili,3848,1906,1942,43.5,25.8833
2017,Ruse,Marten,3426,1715,1711,43.85,25.9333
2017,Ruse,Ruse,144125,69966,74159,43.8486,25.9534
2017,Ruse,Senovo,1260,632,628,43.6167,26.3167
2017,Ruse,Slivo pole,2859,1425,1434,43.85,26.2
2017,Ruse,Silistra,48908,23452,25456,44.1167,27.2667
2017,Ruse,Silistra,48908,23452,25456,44.1167,27.2667
2017,Ruse,Alfatar,1419,693,726,43.95,27.3
2017,Ruse,Glavinitsa,1363,647,716,43.9333,26.8333
2017,Ruse,Dulovo,6378,3075,3303,43.8333,27.1333
2017,Ruse,Silistra,31891,15202,16689,44.1167,27.2667
2017,Ruse,Silistra,31891,15202,16689,44.1167,27.2667
2017,Ruse,Tutrakan,7857,3835,4022,44.05,26.6167
2017,Sliven,Kermen,1512,769,743,42.6333,26.1333
2017,Sliven,Kotel,5268,2511,2757,42.8833,26.45
2017,Sliven,Nova Zagora,20987,10167,10820,42.4833,26.0167
2017,Sliven,Sliven,87063,41583,45480,42.6833,26.3167
2017,Sliven,Tvarditsa,5643,2849,2794,42.7167,26.0167
2017,Sliven,Shivachevo,3636,1815,1821,42.7,26.0667
2017,Smolyan,Devin,6100,2907,3193,41.7444,24.3978
2017,Smolyan,Dospat,2137,1043,1094,41.6436,24.1667
2017,Smolyan,Zlatograd,6429,3039,3390,41.3833,25.1
2017,Smolyan,Madan,5368,2678,2690,41.4833,24.9333
2017,Smolyan,Nedelino,3910,1897,2013,41.5167,25.1
2017,Smolyan,Rudozem,3399,1671,1728,41.4833,24.85
2017,Smolyan,Smolyan,27851,13298,14553,41.5739,24.7128
2017,Smolyan,Chepelare,4839,2371,2468,41.7269,24.6833
2017,Sofia (stolitsa),Bankya,11239,5495,5744,42.6983,23.1342
2017,Sofia (stolitsa),Buhovo,2606,1290,1316,42.7667,23.4667
2017,Sofia (stolitsa),Novi Iskar,14012,6886,7126,42.8022,23.3006
2017,Sofia (stolitsa),Sofia,1238438,592089,646349,42.6977,23.3219
2017,Sofia (oblast),Bozhurishte,5551,2705,2846,42.755,23.1897
2017,Sofia (oblast),Botevgrad,19300,9277,10023,42.9119,23.8106
2017,Sofia (oblast),Godech,3987,1973,2014,43.0122,23.0447
2017,Sofia (oblast),Dolna Banya,4476,2188,2288,42.3,23.7833
2017,Sofia (oblast),Dragoman,3095,1495,1600,42.9225,23.0464
2017,Sofia (oblast),Elin Pelin,6864,3304,3560,42.6667,23.6
2017,Sofia (oblast),Etropole,9733,4880,4853,42.8333,24.0
2017,Sofia (oblast),Zlatitsa,4625,2248,2377,42.7,24.1333
2017,Sofia (oblast),Ihtiman,12692,6274,6418,42.4333,23.8167
2017,Sofia (oblast),Koprivshtitsa,2079,1018,1061,42.6333,24.35
2017,Sofia (oblast),Kostenets,6094,2953,3141,42.3086,23.8578
2017,Sofia (oblast),Kostinbrod,11455,5609,5846,42.8136,23.2178
2017,Sofia (oblast),Momin prohod,1424,672,752,42.4,23.85
2017,Sofia (oblast),Pirdop,6803,3284,3519,42.7,24.1833
2017,Sofia (oblast),Pravets,3624,1816,1808,42.8986,23.9142
2017,Sofia (oblast),Samokov,25218,12136,13082,42.3378,23.5528
2017,Sofia (oblast),Svoge,7587,3773,3814,42.9597,23.3408
2017,Sofia (oblast),Slivnitsa,7102,3542,3560,42.8511,23.0356
2017,Stara Zagora,Gurkovo,2735,1391,1344,42.65,25.8167
2017,Stara Zagora,Galabovo,7496,3784,3712,42.1333,25.8667
2017,Stara Zagora,Kazanlak,44760,21403,23357,42.6167,25.4
2017,Stara Zagora,Kran,3215,1587,1628,42.6658,25.3738
2017,Stara Zagora,Maglizh,3092,1543,1549,42.6167,25.5667
2017,Stara Zagora,Nikolaevo,2765,1363,1402,42.6833,25.85
2017,Stara Zagora,Pavel Banya,2545,1202,1343,42.6167,25.2
2017,Stara Zagora,Radnevo,11735,5817,5918,42.3,25.9333
2017,Stara Zagora,Stara Zagora,136307,65319,70988,42.4258,25.6347
2017,Stara Zagora,Chirpan,14246,6967,7279,42.2,25.3333
2017,Stara Zagora,Shipka,1182,569,613,42.7167,25.3333
2017,Targovishte,Antonovo,1432,708,724,43.15,26.1667
2017,Targovishte,Omurtag,7138,3353,3785,43.1,26.4167
2017,Targovishte,Opaka,2512,1248,1264,43.45,26.1667
2017,Targovishte,Popovo,14218,6813,7405,43.35,26.2333
2017,Targovishte,Targovishte,35446,16906,18540,43.25,26.5833
2017,Haskovo,Dimitrovgrad,34614,16661,17953,42.0519,25.5897
2017,Haskovo,Ivaylovgrad,3312,1649,1663,41.5283,26.1256
2017,Haskovo,Lyubimets,7030,3494,3536,41.8333,26.0833
2017,Haskovo,Madzharovo,584,292,292,41.6292,25.8667
2017,Haskovo,Merichleri,1491,707,784,42.0,25.8
2017,Haskovo,Svilengrad,17598,8705,8893,41.7667,26.2
2017,Haskovo,Simeonovgrad,6792,3369,3423,42.0333,25.8333
2017,Haskovo,Topolovgrad,4892,2387,2505,42.0844,26.3386
2017,Haskovo,Harmanli,19989,10122,9867,41.9333,25.9
2017,Haskovo,Haskovo,71214,33904,37310,41.9333,25.5667
2017,Shumen,Veliki Preslav,7178,3500,3678,43.1667,26.8167
2017,Shumen,Varbitsa,3320,1632,1688,43.1667,26.5833
2017,Shumen,Kaolinovo,1527,775,752,43.3167,27.0167
2017,Shumen,Kaspichan,2778,1349,1429,43.3167,27.1667
2017,Shumen,Novi Pazar,11373,5525,5848,43.35,27.2
2017,Shumen,Pliska,840,404,436,43.3667,27.1167
2017,Shumen,Smyadovo,3586,1752,1834,43.0333,27.05
2017,Shumen,Shumen,75837,36345,39492,43.2714,26.9361
2017,Yambol,Bolyarovo,1095,539,556,42.1,26.8333
2017,Yambol,Elhovo,9413,4577,4836,42.1667,26.5667
2017,Yambol,Straldzha,5647,2834,2813,42.6,26.6833
2017,Yambol,Yambol,68846,33343,35503,42.4833,26.5
2018,Blagoevgrad,Bansko,9062,4400,4662,41.8383,23.488
2018,Blagoevgrad,Belitsa,3024,1472,1552,41.9494,23.5725
2018,Blagoevgrad,Blagoevgrad,69178,32796,36382,42.0167,23.1
2018,Blagoevgrad,Gotse Delchev,18353,8703,9650,41.5667,23.7333
2018,Blagoevgrad,Dobrinishte,2633,1287,1346,41.825,23.5594
2018,Blagoevgrad,Kresna,3286,1657,1629,41.73,23.1569
2018,Blagoevgrad,Melnik,183,92,91,41.5231,23.3925
2018,Blagoevgrad,Petrich,27039,12899,14140,41.3981,23.2072
2018,Blagoevgrad,Razlog,11423,5489,5934,41.8864,23.4678
2018,Blagoevgrad,Sandanski,24908,11871,13037,41.5667,23.2833
2018,Blagoevgrad,Simitli,6334,3179,3155,41.8936,23.1069
2018,Blagoevgrad,Hadzhidimovo,2481,1245,1236,41.5167,23.8667
2018,Blagoevgrad,Yakoruda,5239,2519,2720,42.02,23.6833
2018,Burgas,Aytos,19327,9285,10042,42.7,27.25
2018,Burgas,Aheloy,2262,1149,1113,42.6483,27.6494
2018,Burgas,Ahtopol,1238,611,627,42.1,27.95
2018,Burgas,Burgas,202434,96201,106233,42.4975,27.47
2018,Burgas,Bulgarovo,1528,767,761,42.65,27.3333
2018,Burgas,Kableshkovo,2857,1420,1437,42.6167,27.5667
2018,Burgas,Kameno,4159,2032,2127,42.5667,27.3667
2018,Burgas,Karnobat,17216,8352,8864,42.65,26.9833
2018,Burgas,Kiten,932,460,472,42.2344,27.7711
2018,Burgas,Malko Tarnovo,2017,1025,992,41.9833,27.5333
2018,Burgas,Nesebar,13083,6233,6850,42.66,27.72
2018,Burgas,Obzor,2367,1218,1149,42.8167,27.8833
2018,Burgas,Pomorie,13655,6472,7183,42.55,27.65
2018,Burgas,Primorsko,2924,1461,1463,42.2667,27.75
2018,Burgas,Sveti Vlas,3767,1876,1891,42.7167,27.7667
2018,Burgas,Sozopol,4342,2099,2243,42.4167,27.7
2018,Burgas,Sredets,8614,4247,4367,42.3483,27.1933
2018,Burgas,Sungurlare,2978,1465,1513,42.7667,26.7833
2018,Burgas,Tsarevo,5772,2843,2929,42.17,27.85
2018,Burgas,Chernomorets,2094,1032,1062,42.45,27.64
2018,Varna,Aksakovo,7726,3793,3933,43.2592,27.8211
2018,Varna,Beloslav,7302,3663,3639,43.19,27.7
2018,Varna,Byala,2087,1048,1039,42.8833,27.8833
2018,Varna,Byala,2087,1048,1039,43.4631,25.7214
2018,Varna,Varna,336505,162584,173921,43.2167,27.9167
2018,Varna,Valchi Dol,2857,1392,1465,43.4,27.5333
2018,Varna,Devnya,7786,3879,3907,43.2222,27.57
2018,Varna,Dolni Chiflik,6378,3160,3218,42.9833,27.7333
2018,Varna,Dalgopol,4438,2223,2215,43.05,27.35
2018,Varna,Ignatievo,3955,1925,2030,43.3,27.7
2018,Varna,Provadia,12075,5909,6166,43.1833,27.4333
2018,Varna,Suvorovo,4487,2226,2261,43.33,27.6
2018,Veliko Tarnovo,Byala Cherkva,1669,820,849,43.15,25.3
2018,Veliko Tarnovo,Veliko Tarnovo,68859,32664,36195,43.0833,25.65
2018,Veliko Tarnovo,Gorna Oryahovitsa,28877,13871,15006,43.1278,25.7019
2018,Veliko Tarnovo,Debelets,3779,1857,1922,43.0333,25.6167
2018,Veliko Tarnovo,Dolna Oryahovitsa,2619,1266,1353,43.1167,25.7833
2018,Veliko Tarnovo,Elena,4848,2309,2539,42.9333,25.8833
2018,Veliko Tarnovo,Zlataritsa,2067,1027,1040,43.05,25.9
2018,Veliko Tarnovo,Kilifarevo,2083,1025,1058,42.9833,25.6333
2018,Veliko Tarnovo,Lyaskovets,7445,3542,3903,43.1111,25.7261
2018,Veliko Tarnovo,Pavlikeni,9462,4569,4893,43.2428,25.3219
2018,Veliko Tarnovo,Polski Trambesh,3905,1936,1969,43.3667,25.65
2018,Veliko Tarnovo,Svishtov,25062,12211,12851,43.6239,25.3531
2018,Veliko Tarnovo,Strazhitsa,4237,2079,2158,43.2333,25.9667
2018,Veliko Tarnovo,Suhindol,1623,792,831,43.1833,25.2
2018,Vidin,Belogradchik,4508,2204,2304,43.6278,22.6833
2018,Vidin,Bregovo,2170,1037,1133,44.15,22.65
2018,Vidin,Vidin,41583,20088,21495,43.99,22.8725
2018,Vidin,Gramada,1243,639,604,43.8742,22.6783
2018,Vidin,Dimovo,1029,511,518,43.7417,22.7283
2018,Vidin,Dunavtsi,1848,892,956,44.0,22.8667
2018,Vidin,Kula,2618,1256,1362,43.89,22.5217
2018,Vratsa,Byala Slatina,9856,4761,5095,43.4667,23.9333
2018,Vratsa,Vratsa,52617,25255,27362,43.21,23.5625
2018,Vratsa,Kozloduy,11851,5863,5988,43.7833,23.7333
2018,Vratsa,Krivodol,2626,1294,1332,43.3683,23.4936
2018,Vratsa,Mezdra,9255,4436,4819,43.15,23.7
2018,Vratsa,Mizia,2638,1320,1318,43.6867,23.8458
2018,Vratsa,Oryahovo,4318,2119,2199,43.7358,23.9619
2018,Vratsa,Roman,2534,1236,1298,43.1369,24.125
2018,Gabrovo,Gabrovo,52169,25076,27093,42.8747,25.3186
2018,Gabrovo,Dryanovo,6553,3141,3412,42.9747,25.4781
2018,Gabrovo,Plachkovtsi,1463,727,736,42.8333,25.4333
2018,Gabrovo,Sevlievo,20464,9897,10567,43.0275,25.1125
2018,Gabrovo,Tryavna,8151,3867,4284,42.8672,25.5008
2018,Dobrich,Balchik,11051,5391,5660,43.4072,28.1672
2018,Dobrich,General Toshevo,6155,3000,3155,43.7,28.0333
2018,Dobrich,Dobrich,83584,39850,43734,43.5667,27.8333
2018,Dobrich,Kavarna,10767,5200,5567,43.4358,28.3386
2018,Dobrich,Tervel,5623,2768,2855,43.7472,27.41
2018,Dobrich,Shabla,3079,1514,1565,43.535,28.5339
2018,Kardzhali,Ardino,4002,1991,2011,41.5833,25.1333
2018,Kardzhali,Dzhebel,3185,1562,1623,41.4933,25.305
2018,Kardzhali,Krumovgrad,4824,2336,2488,41.4667,25.65
2018,Kardzhali,Kardzhali,43263,20559,22704,41.65,25.3667
2018,Kardzhali,Momchilgrad,7742,3769,3973,41.5258,25.4061
2018,Kyustendil,Bobovdol,4927,2591,2336,42.3522,23.0333
2018,Kyustendil,Boboshevo,1100,524,576,42.1461,23.0708
2018,Kyustendil,Dupnitsa,29698,14127,15571,42.2667,23.1167
2018,Kyustendil,Kocherinovo,2041,971,1070,42.1167,23.0833
2018,Kyustendil,Kyustendil,39881,19176,20705,42.2833,22.6833
2018,Kyustendil,Rila,2096,1020,1076,42.13,23.3869
2018,Kyustendil,Sapareva Banya,3487,1733,1754,42.2889,23.2672
2018,Lovech,Apriltsi,2497,1198,1299,42.85,24.9167
2018,Lovech,Letnitsa,2446,1213,1233,43.2558,25.0639
2018,Lovech,Lovech,32363,15623,16740,43.1333,24.7167
2018,Lovech,Lukovit,8336,4058,4278,43.2,24.1667
2018,Lovech,Teteven,8675,4233,4442,42.9167,24.2667
2018,Lovech,Troyan,19352,9323,10029,42.89,24.7133
2018,Lovech,Ugarchin,2354,1178,1176,43.1,24.3167
2018,Lovech,Yablanitsa,2566,1285,1281,43.05,24.1
2018,Montana,Berkovitsa,12037,5860,6177,43.2392,23.1272
2018,Montana,Boychinovtsi,1270,625,645,43.4683,23.3044
2018,Montana,Brusartsi,941,457,484,43.7,23.05
2018,Montana,Valchedram,3109,1479,1630,43.715,23.45
2018,Montana,Varshets,5513,2701,2812,43.1981,23.2875
2018,Montana,Lom,19754,9505,10249,43.8139,23.2369
2018,Montana,Montana,39240,18907,20333,43.4125,23.225
2018,Montana,Chiprovtsi,1548,760,788,43.3844,22.8822
2018,Pazardzhik,Batak,2790,1395,1395,41.9442,24.2181
2018,Pazardzhik,Belovo,3374,1653,1721,42.2122,24.015
2018,Pazardzhik,Bratsigovo,3733,1843,1890,42.0128,24.3742
2018,Pazardzhik,Velingrad,21256,10089,11167,42.0278,23.9908
2018,Pazardzhik,Vetren,2782,1377,1405,42.245,24.0894
2018,Pazardzhik,Kostandovo,4020,2004,2016,42.0656,24.0517
2018,Pazardzhik,Pazardzhik,68194,32826,35368,42.1922,24.3331
2018,Pazardzhik,Panagyurishte,16053,7891,8162,42.5,24.1833
2018,Pazardzhik,Peshtera,15837,7751,8086,42.0347,24.2994
2018,Pazardzhik,Rakitovo,7913,3889,4024,41.9878,24.0861
2018,Pazardzhik,Septemvri,7312,3579,3733,42.2167,24.1
2018,Pazardzhik,Strelcha,3758,1786,1972,42.5,24.3167
2018,Pazardzhik,Sarnitsa,3392,1707,1685,41.7858,24.015
2018,Pernik,Batanovtsi,2058,1017,1041,42.5539,23.0325
2018,Pernik,Breznik,3928,1899,2029,42.7394,22.9078
2018,Pernik,Zemen,1474,744,730,42.48,22.7489
2018,Pernik,Pernik,73111,35046,38065,42.6078,23.0375
2018,Pernik,Radomir,12951,6340,6611,42.5453,22.9775
2018,Pernik,Tran,2338,1169,1169,42.8342,22.6519
2018,Pleven,Belene,7063,3790,3273,43.6511,25.1133
2018,Pleven,Gulyantsi,2898,1410,1488,43.6486,24.7125
2018,Pleven,Dolna Mitropolia,2790,1371,1419,43.4667,24.5333
2018,Pleven,Dolni Dabnik,3820,1828,1992,43.4167,24.4333
2018,Pleven,Iskar,2835,1392,1443,43.4608,24.2686
2018,Pleven,Knezha,9366,4559,4807,43.5,24.0833
2018,Pleven,Koynare,3222,1605,1617,43.3667,24.0833
2018,Pleven,Levski,8869,4201,4668,43.4333,25.1333
2018,Pleven,Nikopol,2882,1414,1468,43.7081,24.8983
2018,Pleven,Pleven,96610,45972,50638,43.4167,24.6167
2018,Pleven,Pordim,1810,895,915,43.4167,24.9167
2018,Pleven,Slavyanovo,3549,1724,1825,43.3167,24.8667
2018,Pleven,Trastenik,4016,1970,2046,43.4833,24.55
2018,Pleven,Cherven Bryag,11275,5553,5722,43.2667,24.1
2018,Plovdiv,Asenovgrad,48719,23443,25276,42.0167,24.8667
2018,Plovdiv,Banya,3194,1470,1724,42.5,24.8333
2018,Plovdiv,Brezovo,1653,830,823,42.4833,25.0833
2018,Plovdiv,Kalofer,2746,1273,1473,42.6178,24.98
2018,Plovdiv,Karlovo,21172,10081,11091,42.6333,24.8
2018,Plovdiv,Klisura,925,423,502,42.7,24.45
2018,Plovdiv,Krichim,7906,3891,4015,42.0333,24.4667
2018,Plovdiv,Kuklen,5746,2812,2934,42.0333,24.7833
2018,Plovdiv,Laki,1852,929,923,41.8167,24.8333
2018,Plovdiv,Perushtitsa,4766,2348,2418,42.0333,24.55
2018,Plovdiv,Plovdiv,346893,164739,182154,42.15,24.75
2018,Plovdiv,Parvomay,12120,5729,6391,42.1,25.2167
2018,Plovdiv,Rakovski,14731,7144,7587,42.2833,24.9333
2018,Plovdiv,Sadovo,2439,1221,1218,42.1333,24.8667
2018,Plovdiv,Sopot,8197,3917,4280,42.6667,24.75
2018,Plovdiv,Stamboliyski,10846,5226,5620,42.1333,24.5333
2018,Plovdiv,Saedinenie,5396,2628,2768,42.25,24.6
2018,Plovdiv,Hisarya,6362,3006,3356,42.5,24.7
2018,Razgrad,Zavet,2709,1333,1376,43.7333,26.5833
2018,Razgrad,Isperih,8086,3929,4157,43.7167,26.8333
2018,Razgrad,Kubrat,6362,3050,3312,43.8,26.5
2018,Razgrad,Loznitsa,2036,993,1043,43.4333,26.6167
2018,Razgrad,Razgrad,30575,14399,16176,43.5333,26.5167
2018,Razgrad,Tsar Kaloyan,3234,1573,1661,43.6333,26.2333
2018,Ruse,Borovo,1759,887,872,43.5667,25.8167
2018,Ruse,Byala,7459,3628,3831,42.8833,27.8833
2018,Ruse,Byala,7459,3628,3831,43.4631,25.7214
2018,Ruse,Vetovo,4103,2084,2019,43.7,26.2667
2018,Ruse,Glodzhevo,3171,1587,1584,43.6833,26.5
2018,Ruse,Dve Mogili,3755,1862,1893,43.5,25.8833
2018,Ruse,Marten,3403,1703,1700,43.85,25.9333
2018,Ruse,Ruse,142902,69335,73567,43.8486,25.9534
2018,Ruse,Senovo,1231,617,614,43.6167,26.3167
2018,Ruse,Slivo pole,2851,1410,1441,43.85,26.2
2018,Ruse,Silistra,48382,23147,25235,44.1167,27.2667
2018,Ruse,Silistra,48382,23147,25235,44.1167,27.2667
2018,Ruse,Alfatar,1395,686,709,43.95,27.3
2018,Ruse,Glavinitsa,1341,636,705,43.9333,26.8333
2018,Ruse,Dulovo,6434,3099,3335,43.8333,27.1333
2018,Ruse,Silistra,31468,14967,16501,44.1167,27.2667
2018,Ruse,Silistra,31468,14967,16501,44.1167,27.2667
2018,Ruse,Tutrakan,7744,3759,3985,44.05,26.6167
2018,Sliven,Kermen,1488,744,744,42.6333,26.1333
2018,Sliven,Kotel,5186,2467,2719,42.8833,26.45
2018,Sliven,Nova Zagora,20681,9998,10683,42.4833,26.0167
2018,Sliven,Sliven,86275,41167,45108,42.6833,26.3167
2018,Sliven,Tvarditsa,5659,2853,2806,42.7167,26.0167
2018,Sliven,Shivachevo,3621,1819,1802,42.7,26.0667
2018,Smolyan,Devin,6011,2846,3165,41.7444,24.3978
2018,Smolyan,Dospat,2078,1006,1072,41.6436,24.1667
2018,Smolyan,Zlatograd,6358,2991,3367,41.3833,25.1
2018,Smolyan,Madan,5293,2633,2660,41.4833,24.9333
2018,Smolyan,Nedelino,3809,1846,1963,41.5167,25.1
2018,Smolyan,Rudozem,3385,1663,1722,41.4833,24.85
2018,Smolyan,Smolyan,27505,13148,14357,41.5739,24.7128
2018,Smolyan,Chepelare,4803,2355,2448,41.7269,24.6833
2018,Sofia (stolitsa),Bankya,11234,5492,5742,42.6983,23.1342
2018,Sofia (stolitsa),Buhovo,2580,1292,1288,42.7667,23.4667
2018,Sofia (stolitsa),Novi Iskar,13895,6830,7065,42.8022,23.3006
2018,Sofia (stolitsa),Sofia,1241675,594245,647430,42.6977,23.3219
2018,Sofia (oblast),Bozhurishte,5616,2731,2885,42.755,23.1897
2018,Sofia (oblast),Botevgrad,19212,9185,10027,42.9119,23.8106
2018,Sofia (oblast),Godech,3905,1926,1979,43.0122,23.0447
2018,Sofia (oblast),Dolna Banya,4427,2178,2249,42.3,23.7833
2018,Sofia (oblast),Dragoman,3075,1480,1595,42.9225,23.0464
2018,Sofia (oblast),Elin Pelin,6835,3268,3567,42.6667,23.6
2018,Sofia (oblast),Etropole,9628,4837,4791,42.8333,24.0
2018,Sofia (oblast),Zlatitsa,4552,2206,2346,42.7,24.1333
2018,Sofia (oblast),Ihtiman,12690,6225,6465,42.4333,23.8167
2018,Sofia (oblast),Koprivshtitsa,2046,998,1048,42.6333,24.35
2018,Sofia (oblast),Kostenets,5980,2896,3084,42.3086,23.8578
2018,Sofia (oblast),Kostinbrod,11423,5588,5835,42.8136,23.2178
2018,Sofia (oblast),Momin prohod,1384,658,726,42.4,23.85
2018,Sofia (oblast),Pirdop,6675,3222,3453,42.7,24.1833
2018,Sofia (oblast),Pravets,3587,1789,1798,42.8986,23.9142
2018,Sofia (oblast),Samokov,25138,12100,13038,42.3378,23.5528
2018,Sofia (oblast),Svoge,7555,3753,3802,42.9597,23.3408
2018,Sofia (oblast),Slivnitsa,7032,3486,3546,42.8511,23.0356
2018,Stara Zagora,Gurkovo,2723,1387,1336,42.65,25.8167
2018,Stara Zagora,Galabovo,7397,3732,3665,42.1333,25.8667
2018,Stara Zagora,Kazanlak,45020,21396,23624,42.6167,25.4
2018,Stara Zagora,Kran,3120,1544,1576,42.6658,25.3738
2018,Stara Zagora,Maglizh,3019,1514,1505,42.6167,25.5667
2018,Stara Zagora,Nikolaevo,2759,1387,1372,42.6833,25.85
2018,Stara Zagora,Pavel Banya,2489,1170,1319,42.6167,25.2
2018,Stara Zagora,Radnevo,11587,5747,5840,42.3,25.9333
2018,Stara Zagora,Stara Zagora,135715,64966,70749,42.4258,25.6347
2018,Stara Zagora,Chirpan,14149,6914,7235,42.2,25.3333
2018,Stara Zagora,Shipka,1154,554,600,42.7167,25.3333
2018,Targovishte,Antonovo,1409,694,715,43.15,26.1667
2018,Targovishte,Omurtag,7074,3339,3735,43.1,26.4167
2018,Targovishte,Opaka,2470,1232,1238,43.45,26.1667
2018,Targovishte,Popovo,14008,6701,7307,43.35,26.2333
2018,Targovishte,Targovishte,35453,16861,18592,43.25,26.5833
2018,Haskovo,Dimitrovgrad,33899,16287,17612,42.0519,25.5897
2018,Haskovo,Ivaylovgrad,3233,1605,1628,41.5283,26.1256
2018,Haskovo,Lyubimets,6970,3458,3512,41.8333,26.0833
2018,Haskovo,Madzharovo,597,308,289,41.6292,25.8667
2018,Haskovo,Merichleri,1467,696,771,42.0,25.8
2018,Haskovo,Svilengrad,17358,8577,8781,41.7667,26.2
2018,Haskovo,Simeonovgrad,6985,3488,3497,42.0333,25.8333
2018,Haskovo,Topolovgrad,4811,2351,2460,42.0844,26.3386
2018,Haskovo,Harmanli,19734,9980,9754,41.9333,25.9
2018,Haskovo,Haskovo,70406,33452,36954,41.9333,25.5667
2018,Shumen,Veliki Preslav,7103,3454,3649,43.1667,26.8167
2018,Shumen,Varbitsa,3343,1643,1700,43.1667,26.5833
2018,Shumen,Kaolinovo,1529,777,752,43.3167,27.0167
2018,Shumen,Kaspichan,2719,1322,1397,43.3167,27.1667
2018,Shumen,Novi Pazar,11315,5491,5824,43.35,27.2
2018,Shumen,Pliska,823,396,427,43.3667,27.1167
2018,Shumen,Smyadovo,3576,1736,1840,43.0333,27.05
2018,Shumen,Shumen,75500,36147,39353,43.2714,26.9361
2018,Yambol,Bolyarovo,1099,546,553,42.1,26.8333
2018,Yambol,Elhovo,9373,4548,4825,42.1667,26.5667
2018,Yambol,Straldzha,5573,2812,2761,42.6,26.6833
2018,Yambol,Yambol,68074,32926,35148,42.4833,26.5
2019,Blagoevgrad,Bansko,9185,4461,4724,41.8383,23.488
2019,Blagoevgrad,Belitsa,2968,1443,1525,41.9494,23.5725
2019,Blagoevgrad,Blagoevgrad,68679,32583,36096,42.0167,23.1
2019,Blagoevgrad,Gotse Delchev,18250,8646,9604,41.5667,23.7333
2019,Blagoevgrad,Dobrinishte,2588,1262,1326,41.825,23.5594
2019,Blagoevgrad,Kresna,3459,1762,1697,41.73,23.1569
2019,Blagoevgrad,Melnik,177,87,90,41.5231,23.3925
2019,Blagoevgrad,Petrich,26932,12824,14108,41.3981,23.2072
2019,Blagoevgrad,Razlog,11295,5419,5876,41.8864,23.4678
2019,Blagoevgrad,Sandanski,24722,11715,13007,41.5667,23.2833
2019,Blagoevgrad,Simitli,6263,3132,3131,41.8936,23.1069
2019,Blagoevgrad,Hadzhidimovo,2444,1227,1217,41.5167,23.8667
2019,Blagoevgrad,Yakoruda,5175,2473,2702,42.02,23.6833
2019,Burgas,Aytos,19135,9175,9960,42.7,27.25
2019,Burgas,Aheloy,2275,1143,1132,42.6483,27.6494
2019,Burgas,Ahtopol,1201,593,608,42.1,27.95
2019,Burgas,Burgas,201779,95633,106146,42.4975,27.47
2019,Burgas,Bulgarovo,1520,761,759,42.65,27.3333
2019,Burgas,Kableshkovo,2817,1405,1412,42.6167,27.5667
2019,Burgas,Kameno,4103,2000,2103,42.5667,27.3667
2019,Burgas,Karnobat,16971,8216,8755,42.65,26.9833
2019,Burgas,Kiten,989,484,505,42.2344,27.7711
2019,Burgas,Malko Tarnovo,1965,1000,965,41.9833,27.5333
2019,Burgas,Nesebar,13600,6463,7137,42.66,27.72
2019,Burgas,Obzor,2423,1263,1160,42.8167,27.8833
2019,Burgas,Pomorie,13734,6472,7262,42.55,27.65
2019,Burgas,Primorsko,2937,1472,1465,42.2667,27.75
2019,Burgas,Sveti Vlas,4097,2025,2072,42.7167,27.7667
2019,Burgas,Sozopol,4314,2086,2228,42.4167,27.7
2019,Burgas,Sredets,8512,4215,4297,42.3483,27.1933
2019,Burgas,Sungurlare,2953,1458,1495,42.7667,26.7833
2019,Burgas,Tsarevo,5693,2807,2886,42.17,27.85
2019,Burgas,Chernomorets,2114,1041,1073,42.45,27.64
2019,Varna,Aksakovo,7658,3760,3898,43.2592,27.8211
2019,Varna,Beloslav,7226,3620,3606,43.19,27.7
2019,Varna,Byala,2120,1061,1059,42.8833,27.8833
2019,Varna,Byala,2120,1061,1059,43.4631,25.7214
2019,Varna,Varna,336216,162280,173936,43.2167,27.9167
2019,Varna,Valchi Dol,2833,1385,1448,43.4,27.5333
2019,Varna,Devnya,7727,3841,3886,43.2222,27.57
2019,Varna,Dolni Chiflik,6324,3119,3205,42.9833,27.7333
2019,Varna,Dalgopol,4413,2211,2202,43.05,27.35
2019,Varna,Ignatievo,3932,1919,2013,43.3,27.7
2019,Varna,Provadia,11903,5821,6082,43.1833,27.4333
2019,Varna,Suvorovo,4443,2178,2265,43.33,27.6
2019,Veliko Tarnovo,Byala Cherkva,1665,822,843,43.15,25.3
2019,Veliko Tarnovo,Veliko Tarnovo,68828,32625,36203,43.0833,25.65
2019,Veliko Tarnovo,Gorna Oryahovitsa,28429,13615,14814,43.1278,25.7019
2019,Veliko Tarnovo,Debelets,3689,1810,1879,43.0333,25.6167
2019,Veliko Tarnovo,Dolna Oryahovitsa,2605,1266,1339,43.1167,25.7833
2019,Veliko Tarnovo,Elena,4745,2263,2482,42.9333,25.8833
2019,Veliko Tarnovo,Zlataritsa,2085,1023,1062,43.05,25.9
2019,Veliko Tarnovo,Kilifarevo,2055,1013,1042,42.9833,25.6333
2019,Veliko Tarnovo,Lyaskovets,7338,3486,3852,43.1111,25.7261
2019,Veliko Tarnovo,Pavlikeni,9235,4457,4778,43.2428,25.3219
2019,Veliko Tarnovo,Polski Trambesh,3829,1909,1920,43.3667,25.65
2019,Veliko Tarnovo,Svishtov,24275,11864,12411,43.6239,25.3531
2019,Veliko Tarnovo,Strazhitsa,4165,2039,2126,43.2333,25.9667
2019,Veliko Tarnovo,Suhindol,1595,778,817,43.1833,25.2
2019,Vidin,Belogradchik,4409,2153,2256,43.6278,22.6833
2019,Vidin,Bregovo,2082,1007,1075,44.15,22.65
2019,Vidin,Vidin,40620,19589,21031,43.99,22.8725
2019,Vidin,Gramada,1263,657,606,43.8742,22.6783
2019,Vidin,Dimovo,1020,510,510,43.7417,22.7283
2019,Vidin,Dunavtsi,1826,876,950,44.0,22.8667
2019,Vidin,Kula,2554,1224,1330,43.89,22.5217
2019,Vratsa,Byala Slatina,9644,4643,5001,43.4667,23.9333
2019,Vratsa,Vratsa,51674,24725,26949,43.21,23.5625
2019,Vratsa,Kozloduy,11666,5760,5906,43.7833,23.7333
2019,Vratsa,Krivodol,2583,1255,1328,43.3683,23.4936
2019,Vratsa,Mezdra,9079,4336,4743,43.15,23.7
2019,Vratsa,Mizia,2564,1275,1289,43.6867,23.8458
2019,Vratsa,Oryahovo,4204,2065,2139,43.7358,23.9619
2019,Vratsa,Roman,2491,1211,1280,43.1369,24.125
2019,Gabrovo,Gabrovo,51217,24604,26613,42.8747,25.3186
2019,Gabrovo,Dryanovo,6455,3091,3364,42.9747,25.4781
2019,Gabrovo,Plachkovtsi,1399,695,704,42.8333,25.4333
2019,Gabrovo,Sevlievo,20210,9748,10462,43.0275,25.1125
2019,Gabrovo,Tryavna,7984,3775,4209,42.8672,25.5008
2019,Dobrich,Balchik,10962,5324,5638,43.4072,28.1672
2019,Dobrich,General Toshevo,6029,2938,3091,43.7,28.0333
2019,Dobrich,Dobrich,82240,39109,43131,43.5667,27.8333
2019,Dobrich,Kavarna,10690,5145,5545,43.4358,28.3386
2019,Dobrich,Tervel,5557,2744,2813,43.7472,27.41
2019,Dobrich,Shabla,3014,1484,1530,43.535,28.5339
2019,Kardzhali,Ardino,4135,2053,2082,41.5833,25.1333
2019,Kardzhali,Dzhebel,3297,1608,1689,41.4933,25.305
2019,Kardzhali,Krumovgrad,4903,2360,2543,41.4667,25.65
2019,Kardzhali,Kardzhali,43600,20646,22954,41.65,25.3667
2019,Kardzhali,Momchilgrad,7921,3852,4069,41.5258,25.4061
2019,Kyustendil,Bobovdol,4793,2503,2290,42.3522,23.0333
2019,Kyustendil,Boboshevo,1145,552,593,42.1461,23.0708
2019,Kyustendil,Dupnitsa,29134,13811,15323,42.2667,23.1167
2019,Kyustendil,Kocherinovo,1987,941,1046,42.1167,23.0833
2019,Kyustendil,Kyustendil,39284,18942,20342,42.2833,22.6833
2019,Kyustendil,Rila,2039,993,1046,42.13,23.3869
2019,Kyustendil,Sapareva Banya,3502,1741,1761,42.2889,23.2672
2019,Lovech,Apriltsi,2419,1164,1255,42.85,24.9167
2019,Lovech,Letnitsa,2408,1191,1217,43.2558,25.0639
2019,Lovech,Lovech,31695,15250,16445,43.1333,24.7167
2019,Lovech,Lukovit,8217,3991,4226,43.2,24.1667
2019,Lovech,Teteven,8548,4169,4379,42.9167,24.2667
2019,Lovech,Troyan,19055,9173,9882,42.89,24.7133
2019,Lovech,Ugarchin,2322,1162,1160,43.1,24.3167
2019,Lovech,Yablanitsa,2516,1261,1255,43.05,24.1
2019,Montana,Berkovitsa,11841,5767,6074,43.2392,23.1272
2019,Montana,Boychinovtsi,1253,614,639,43.4683,23.3044
2019,Montana,Brusartsi,913,451,462,43.7,23.05
2019,Montana,Valchedram,3016,1433,1583,43.715,23.45
2019,Montana,Varshets,5444,2669,2775,43.1981,23.2875
2019,Montana,Lom,19361,9327,10034,43.8139,23.2369
2019,Montana,Montana,38341,18440,19901,43.4125,23.225
2019,Montana,Chiprovtsi,1520,744,776,43.3844,22.8822
2019,Pazardzhik,Batak,2706,1363,1343,41.9442,24.2181
2019,Pazardzhik,Belovo,3315,1610,1705,42.2122,24.015
2019,Pazardzhik,Bratsigovo,3658,1798,1860,42.0128,24.3742
2019,Pazardzhik,Velingrad,21076,9987,11089,42.0278,23.9908
2019,Pazardzhik,Vetren,2742,1362,1380,42.245,24.0894
2019,Pazardzhik,Kostandovo,3992,1993,1999,42.0656,24.0517
2019,Pazardzhik,Pazardzhik,67650,32481,35169,42.1922,24.3331
2019,Pazardzhik,Panagyurishte,15839,7758,8081,42.5,24.1833
2019,Pazardzhik,Peshtera,15644,7650,7994,42.0347,24.2994
2019,Pazardzhik,Rakitovo,7871,3885,3986,41.9878,24.0861
2019,Pazardzhik,Septemvri,7201,3535,3666,42.2167,24.1
2019,Pazardzhik,Strelcha,3738,1764,1974,42.5,24.3167
2019,Pazardzhik,Sarnitsa,3382,1701,1681,41.7858,24.015
2019,Pernik,Batanovtsi,2032,1005,1027,42.5539,23.0325
2019,Pernik,Breznik,3850,1857,1993,42.7394,22.9078
2019,Pernik,Zemen,1461,744,717,42.48,22.7489
2019,Pernik,Pernik,72241,34567,37674,42.6078,23.0375
2019,Pernik,Radomir,12843,6285,6558,42.5453,22.9775
2019,Pernik,Tran,2320,1160,1160,42.8342,22.6519
2019,Pleven,Belene,6860,3670,3190,43.6511,25.1133
2019,Pleven,Gulyantsi,2835,1380,1455,43.6486,24.7125
2019,Pleven,Dolna Mitropolia,2780,1372,1408,43.4667,24.5333
2019,Pleven,Dolni Dabnik,3759,1785,1974,43.4167,24.4333
2019,Pleven,Iskar,2770,1363,1407,43.4608,24.2686
2019,Pleven,Knezha,9207,4484,4723,43.5,24.0833
2019,Pleven,Koynare,3155,1569,1586,43.3667,24.0833
2019,Pleven,Levski,8623,4079,4544,43.4333,25.1333
2019,Pleven,Nikopol,2828,1383,1445,43.7081,24.8983
2019,Pleven,Pleven,95086,45074,50012,43.4167,24.6167
2019,Pleven,Pordim,1812,893,919,43.4167,24.9167
2019,Pleven,Slavyanovo,3490,1688,1802,43.3167,24.8667
2019,Pleven,Trastenik,3931,1932,1999,43.4833,24.55
2019,Pleven,Cherven Bryag,11050,5412,5638,43.2667,24.1
2019,Plovdiv,Asenovgrad,48483,23315,25168,42.0167,24.8667
2019,Plovdiv,Banya,3139,1450,1689,42.5,24.8333
2019,Plovdiv,Brezovo,1626,821,805,42.4833,25.0833
2019,Plovdiv,Kalofer,2695,1246,1449,42.6178,24.98
2019,Plovdiv,Karlovo,20809,9883,10926,42.6333,24.8
2019,Plovdiv,Klisura,895,411,484,42.7,24.45
2019,Plovdiv,Krichim,7817,3847,3970,42.0333,24.4667
2019,Plovdiv,Kuklen,5763,2820,2943,42.0333,24.7833
2019,Plovdiv,Laki,1808,902,906,41.8167,24.8333
2019,Plovdiv,Perushtitsa,4710,2318,2392,42.0333,24.55
2019,Plovdiv,Plovdiv,347851,164971,182880,42.15,24.75
2019,Plovdiv,Parvomay,11915,5608,6307,42.1,25.2167
2019,Plovdiv,Rakovski,14692,7134,7558,42.2833,24.9333
2019,Plovdiv,Sadovo,2424,1207,1217,42.1333,24.8667
2019,Plovdiv,Sopot,8177,3915,4262,42.6667,24.75
2019,Plovdiv,Stamboliyski,10758,5155,5603,42.1333,24.5333
2019,Plovdiv,Saedinenie,5329,2586,2743,42.25,24.6
2019,Plovdiv,Hisarya,6267,2958,3309,42.5,24.7
2019,Razgrad,Zavet,2638,1299,1339,43.7333,26.5833
2019,Razgrad,Isperih,7928,3859,4069,43.7167,26.8333
2019,Razgrad,Kubrat,6259,3013,3246,43.8,26.5
2019,Razgrad,Loznitsa,2008,972,1036,43.4333,26.6167
2019,Razgrad,Razgrad,30173,14194,15979,43.5333,26.5167
2019,Razgrad,Tsar Kaloyan,3153,1526,1627,43.6333,26.2333
2019,Ruse,Borovo,1733,867,866,43.5667,25.8167
2019,Ruse,Byala,7329,3546,3783,42.8833,27.8833
2019,Ruse,Byala,7329,3546,3783,43.4631,25.7214
2019,Ruse,Vetovo,4024,2056,1968,43.7,26.2667
2019,Ruse,Glodzhevo,3153,1576,1577,43.6833,26.5
2019,Ruse,Dve Mogili,3647,1805,1842,43.5,25.8833
2019,Ruse,Marten,3369,1677,1692,43.85,25.9333
2019,Ruse,Ruse,141231,68407,72824,43.8486,25.9534
2019,Ruse,Senovo,1219,611,608,43.6167,26.3167
2019,Ruse,Slivo pole,2814,1387,1427,43.85,26.2
2019,Ruse,Silistra,47781,22812,24969,44.1167,27.2667
2019,Ruse,Silistra,47781,22812,24969,44.1167,27.2667
2019,Ruse,Alfatar,1382,675,707,43.95,27.3
2019,Ruse,Glavinitsa,1310,626,684,43.9333,26.8333
2019,Ruse,Dulovo,6430,3106,3324,43.8333,27.1333
2019,Ruse,Silistra,30983,14689,16294,44.1167,27.2667
2019,Ruse,Silistra,30983,14689,16294,44.1167,27.2667
2019,Ruse,Tutrakan,7676,3716,3960,44.05,26.6167
2019,Sliven,Kermen,1520,751,769,42.6333,26.1333
2019,Sliven,Kotel,5092,2422,2670,42.8833,26.45
2019,Sliven,Nova Zagora,20239,9768,10471,42.4833,26.0167
2019,Sliven,Sliven,84985,40462,44523,42.6833,26.3167
2019,Sliven,Tvarditsa,5569,2815,2754,42.7167,26.0167
2019,Sliven,Shivachevo,3628,1812,1816,42.7,26.0667
2019,Smolyan,Devin,5927,2782,3145,41.7444,24.3978
2019,Smolyan,Dospat,2058,992,1066,41.6436,24.1667
2019,Smolyan,Zlatograd,6248,2927,3321,41.3833,25.1
2019,Smolyan,Madan,5233,2589,2644,41.4833,24.9333
2019,Smolyan,Nedelino,3766,1812,1954,41.5167,25.1
2019,Smolyan,Rudozem,3364,1648,1716,41.4833,24.85
2019,Smolyan,Smolyan,27092,12889,14203,41.5739,24.7128
2019,Smolyan,Chepelare,4713,2308,2405,41.7269,24.6833
2019,Sofia (stolitsa),Bankya,11294,5520,5774,42.6983,23.1342
2019,Sofia (stolitsa),Buhovo,2545,1274,1271,42.7667,23.4667
2019,Sofia (stolitsa),Novi Iskar,13762,6760,7002,42.8022,23.3006
2019,Sofia (stolitsa),Sofia,1242568,594890,647678,42.6977,23.3219
2019,Sofia (oblast),Bozhurishte,5675,2784,2891,42.755,23.1897
2019,Sofia (oblast),Botevgrad,19086,9105,9981,42.9119,23.8106
2019,Sofia (oblast),Godech,3872,1894,1978,43.0122,23.0447
2019,Sofia (oblast),Dolna Banya,4369,2138,2231,42.3,23.7833
2019,Sofia (oblast),Dragoman,3014,1454,1560,42.9225,23.0464
2019,Sofia (oblast),Elin Pelin,6802,3256,3546,42.6667,23.6
2019,Sofia (oblast),Etropole,9545,4794,4751,42.8333,24.0
2019,Sofia (oblast),Zlatitsa,4461,2156,2305,42.7,24.1333
2019,Sofia (oblast),Ihtiman,12641,6216,6425,42.4333,23.8167
2019,Sofia (oblast),Koprivshtitsa,1976,961,1015,42.6333,24.35
2019,Sofia (oblast),Kostenets,5877,2834,3043,42.3086,23.8578
2019,Sofia (oblast),Kostinbrod,11321,5519,5802,42.8136,23.2178
2019,Sofia (oblast),Momin prohod,1365,655,710,42.4,23.85
2019,Sofia (oblast),Pirdop,6547,3141,3406,42.7,24.1833
2019,Sofia (oblast),Pravets,3573,1776,1797,42.8986,23.9142
2019,Sofia (oblast),Samokov,25016,12026,12990,42.3378,23.5528
2019,Sofia (oblast),Svoge,7438,3676,3762,42.9597,23.3408
2019,Sofia (oblast),Slivnitsa,6982,3464,3518,42.8511,23.0356
2019,Stara Zagora,Gurkovo,2729,1376,1353,42.65,25.8167
2019,Stara Zagora,Galabovo,7251,3656,3595,42.1333,25.8667
2019,Stara Zagora,Kazanlak,44699,21150,23549,42.6167,25.4
2019,Stara Zagora,Kran,3031,1505,1526,42.6658,25.3738
2019,Stara Zagora,Maglizh,2957,1479,1478,42.6167,25.5667
2019,Stara Zagora,Nikolaevo,2722,1358,1364,42.6833,25.85
2019,Stara Zagora,Pavel Banya,2561,1202,1359,42.6167,25.2
2019,Stara Zagora,Radnevo,11291,5579,5712,42.3,25.9333
2019,Stara Zagora,Stara Zagora,134726,64316,70410,42.4258,25.6347
2019,Stara Zagora,Chirpan,13911,6800,7111,42.2,25.3333
2019,Stara Zagora,Shipka,1119,531,588,42.7167,25.3333
2019,Targovishte,Antonovo,1404,689,715,43.15,26.1667
2019,Targovishte,Omurtag,7079,3341,3738,43.1,26.4167
2019,Targovishte,Opaka,2447,1218,1229,43.45,26.1667
2019,Targovishte,Popovo,13776,6585,7191,43.35,26.2333
2019,Targovishte,Targovishte,35344,16759,18585,43.25,26.5833
2019,Haskovo,Dimitrovgrad,33088,15885,17203,42.0519,25.5897
2019,Haskovo,Ivaylovgrad,3168,1572,1596,41.5283,26.1256
2019,Haskovo,Lyubimets,6859,3405,3454,41.8333,26.0833
2019,Haskovo,Madzharovo,575,296,279,41.6292,25.8667
2019,Haskovo,Merichleri,1450,691,759,42.0,25.8
2019,Haskovo,Svilengrad,17184,8471,8713,41.7667,26.2
2019,Haskovo,Simeonovgrad,7020,3525,3495,42.0333,25.8333
2019,Haskovo,Topolovgrad,4701,2295,2406,42.0844,26.3386
2019,Haskovo,Harmanli,19395,9819,9576,41.9333,25.9
2019,Haskovo,Haskovo,69219,32776,36443,41.9333,25.5667
2019,Shumen,Veliki Preslav,6981,3382,3599,43.1667,26.8167
2019,Shumen,Varbitsa,3379,1666,1713,43.1667,26.5833
2019,Shumen,Kaolinovo,1527,781,746,43.3167,27.0167
2019,Shumen,Kaspichan,2700,1312,1388,43.3167,27.1667
2019,Shumen,Novi Pazar,11086,5391,5695,43.35,27.2
2019,Shumen,Pliska,804,380,424,43.3667,27.1167
2019,Shumen,Smyadovo,3559,1724,1835,43.0333,27.05
2019,Shumen,Shumen,75442,35930,39512,43.2714,26.9361
2019,Yambol,Bolyarovo,1113,558,555,42.1,26.8333
2019,Yambol,Elhovo,9211,4462,4749,42.1667,26.5667
2019,Yambol,Straldzha,5503,2782,2721,42.6,26.6833
2019,Yambol,Yambol,67222,32452,34770,42.4833,26.5
2020,Blagoevgrad,Bansko,9344,4505,4839,41.8383,23.488
2020,Blagoevgrad,Belitsa,2936,1429,1507,41.9494,23.5725
2020,Blagoevgrad,Blagoevgrad,68179,32350,35829,42.0167,23.1
2020,Blagoevgrad,Gotse Delchev,18269,8631,9638,41.5667,23.7333
2020,Blagoevgrad,Dobrinishte,2579,1245,1334,41.825,23.5594
2020,Blagoevgrad,Kresna,3335,1688,1647,41.73,23.1569
2020,Blagoevgrad,Melnik,162,83,79,41.5231,23.3925
2020,Blagoevgrad,Petrich,26933,12826,14107,41.3981,23.2072
2020,Blagoevgrad,Razlog,11267,5410,5857,41.8864,23.4678
2020,Blagoevgrad,Sandanski,24770,11721,13049,41.5667,23.2833
2020,Blagoevgrad,Simitli,6222,3127,3095,41.8936,23.1069
2020,Blagoevgrad,Hadzhidimovo,2409,1197,1212,41.5167,23.8667
2020,Blagoevgrad,Yakoruda,5108,2434,2674,42.02,23.6833
2020,Burgas,Aytos,19142,9166,9976,42.7,27.25
2020,Burgas,Aheloy,2285,1143,1142,42.6483,27.6494
2020,Burgas,Ahtopol,1208,593,615,42.1,27.95
2020,Burgas,Burgas,198593,93792,104801,42.4975,27.47
2020,Burgas,Bulgarovo,1562,774,788,42.65,27.3333
2020,Burgas,Kableshkovo,2899,1440,1459,42.6167,27.5667
2020,Burgas,Kameno,4096,2004,2092,42.5667,27.3667
2020,Burgas,Karnobat,16808,8096,8712,42.65,26.9833
2020,Burgas,Kiten,982,482,500,42.2344,27.7711
2020,Burgas,Malko Tarnovo,1934,984,950,41.9833,27.5333
2020,Burgas,Nesebar,14080,6671,7409,42.66,27.72
2020,Burgas,Obzor,2402,1247,1155,42.8167,27.8833
2020,Burgas,Pomorie,13926,6535,7391,42.55,27.65
2020,Burgas,Primorsko,2980,1500,1480,42.2667,27.75
2020,Burgas,Sveti Vlas,4266,2107,2159,42.7167,27.7667
2020,Burgas,Sozopol,4513,2185,2328,42.4167,27.7
2020,Burgas,Sredets,8447,4197,4250,42.3483,27.1933
2020,Burgas,Sungurlare,2928,1452,1476,42.7667,26.7833
2020,Burgas,Tsarevo,5738,2821,2917,42.17,27.85
2020,Burgas,Chernomorets,2458,1204,1254,42.45,27.64
2020,Varna,Aksakovo,7617,3730,3887,43.2592,27.8211
2020,Varna,Beloslav,7206,3613,3593,43.19,27.7
2020,Varna,Byala,2204,1105,1099,42.8833,27.8833
2020,Varna,Byala,2204,1105,1099,43.4631,25.7214
2020,Varna,Varna,332394,160041,172353,43.2167,27.9167
2020,Varna,Valchi Dol,2773,1361,1412,43.4,27.5333
2020,Varna,Devnya,7797,3891,3906,43.2222,27.57
2020,Varna,Dolni Chiflik,6333,3115,3218,42.9833,27.7333
2020,Varna,Dalgopol,4365,2192,2173,43.05,27.35
2020,Varna,Ignatievo,3961,1927,2034,43.3,27.7
2020,Varna,Provadia,11764,5752,6012,43.1833,27.4333
2020,Varna,Suvorovo,4502,2204,2298,43.33,27.6
2020,Veliko Tarnovo,Byala Cherkva,1656,817,839,43.15,25.3
2020,Veliko Tarnovo,Veliko Tarnovo,66103,31078,35025,43.0833,25.65
2020,Veliko Tarnovo,Gorna Oryahovitsa,27876,13286,14590,43.1278,25.7019
2020,Veliko Tarnovo,Debelets,3693,1791,1902,43.0333,25.6167
2020,Veliko Tarnovo,Dolna Oryahovitsa,2583,1258,1325,43.1167,25.7833
2020,Veliko Tarnovo,Elena,4643,2212,2431,42.9333,25.8833
2020,Veliko Tarnovo,Zlataritsa,2040,1004,1036,43.05,25.9
2020,Veliko Tarnovo,Kilifarevo,2152,1056,1096,42.9833,25.6333
2020,Veliko Tarnovo,Lyaskovets,7192,3417,3775,43.1111,25.7261
2020,Veliko Tarnovo,Pavlikeni,9121,4384,4737,43.2428,25.3219
2020,Veliko Tarnovo,Polski Trambesh,3810,1895,1915,43.3667,25.65
2020,Veliko Tarnovo,Svishtov,23576,11540,12036,43.6239,25.3531
2020,Veliko Tarnovo,Strazhitsa,4149,2025,2124,43.2333,25.9667
2020,Veliko Tarnovo,Suhindol,1592,777,815,43.1833,25.2
2020,Vidin,Belogradchik,4339,2115,2224,43.6278,22.6833
2020,Vidin,Bregovo,2021,973,1048,44.15,22.65
2020,Vidin,Vidin,39568,18986,20582,43.99,22.8725
2020,Vidin,Gramada,1216,634,582,43.8742,22.6783
2020,Vidin,Dimovo,985,483,502,43.7417,22.7283
2020,Vidin,Dunavtsi,1847,891,956,44.0,22.8667
2020,Vidin,Kula,2463,1179,1284,43.89,22.5217
2020,Vratsa,Byala Slatina,9495,4576,4919,43.4667,23.9333
2020,Vratsa,Vratsa,51020,24381,26639,43.21,23.5625
2020,Vratsa,Kozloduy,11552,5682,5870,43.7833,23.7333
2020,Vratsa,Krivodol,2544,1242,1302,43.3683,23.4936
2020,Vratsa,Mezdra,8963,4282,4681,43.15,23.7
2020,Vratsa,Mizia,2504,1235,1269,43.6867,23.8458
2020,Vratsa,Oryahovo,4118,2024,2094,43.7358,23.9619
2020,Vratsa,Roman,2443,1184,1259,43.1369,24.125
2020,Gabrovo,Gabrovo,49175,23523,25652,42.8747,25.3186
2020,Gabrovo,Dryanovo,6271,3009,3262,42.9747,25.4781
2020,Gabrovo,Plachkovtsi,1416,702,714,42.8333,25.4333
2020,Gabrovo,Sevlievo,19875,9546,10329,43.0275,25.1125
2020,Gabrovo,Tryavna,7809,3668,4141,42.8672,25.5008
2020,Dobrich,Balchik,10985,5321,5664,43.4072,28.1672
2020,Dobrich,General Toshevo,5963,2910,3053,43.7,28.0333
2020,Dobrich,Dobrich,80936,38328,42608,43.5667,27.8333
2020,Dobrich,Kavarna,10627,5138,5489,43.4358,28.3386
2020,Dobrich,Tervel,5480,2696,2784,43.7472,27.41
2020,Dobrich,Shabla,3003,1475,1528,43.535,28.5339
2020,Kardzhali,Ardino,4195,2084,2111,41.5833,25.1333
2020,Kardzhali,Dzhebel,3358,1633,1725,41.4933,25.305
2020,Kardzhali,Krumovgrad,4935,2355,2580,41.4667,25.65
2020,Kardzhali,Kardzhali,44123,20871,23252,41.65,25.3667
2020,Kardzhali,Momchilgrad,8075,3943,4132,41.5258,25.4061
2020,Kyustendil,Bobovdol,4665,2444,2221,42.3522,23.0333
2020,Kyustendil,Boboshevo,1158,552,606,42.1461,23.0708
2020,Kyustendil,Dupnitsa,28881,13644,15237,42.2667,23.1167
2020,Kyustendil,Kocherinovo,2007,955,1052,42.1167,23.0833
2020,Kyustendil,Kyustendil,38629,18571,20058,42.2833,22.6833
2020,Kyustendil,Rila,2061,1007,1054,42.13,23.3869
2020,Kyustendil,Sapareva Banya,3523,1741,1782,42.2889,23.2672
2020,Lovech,Apriltsi,2503,1212,1291,42.85,24.9167
2020,Lovech,Letnitsa,2387,1187,1200,43.2558,25.0639
2020,Lovech,Lovech,30353,14517,15836,43.1333,24.7167
2020,Lovech,Lukovit,8197,3975,4222,43.2,24.1667
2020,Lovech,Teteven,8496,4131,4365,42.9167,24.2667
2020,Lovech,Troyan,18889,9074,9815,42.89,24.7133
2020,Lovech,Ugarchin,2339,1173,1166,43.1,24.3167
2020,Lovech,Yablanitsa,2516,1264,1252,43.05,24.1
2020,Montana,Berkovitsa,11668,5651,6017,43.2392,23.1272
2020,Montana,Boychinovtsi,1246,611,635,43.4683,23.3044
2020,Montana,Brusartsi,900,440,460,43.7,23.05
2020,Montana,Valchedram,2978,1406,1572,43.715,23.45
2020,Montana,Varshets,5365,2627,2738,43.1981,23.2875
2020,Montana,Lom,19033,9132,9901,43.8139,23.2369
2020,Montana,Montana,37122,17749,19373,43.4125,23.225
2020,Montana,Chiprovtsi,1505,728,777,43.3844,22.8822
2020,Pazardzhik,Batak,2650,1327,1323,41.9442,24.2181
2020,Pazardzhik,Belovo,3307,1603,1704,42.2122,24.015
2020,Pazardzhik,Bratsigovo,3675,1817,1858,42.0128,24.3742
2020,Pazardzhik,Velingrad,21026,9963,11063,42.0278,23.9908
2020,Pazardzhik,Vetren,2803,1393,1410,42.245,24.0894
2020,Pazardzhik,Kostandovo,4008,1994,2014,42.0656,24.0517
2020,Pazardzhik,Pazardzhik,66690,31949,34741,42.1922,24.3331
2020,Pazardzhik,Panagyurishte,15628,7597,8031,42.5,24.1833
2020,Pazardzhik,Peshtera,15452,7556,7896,42.0347,24.2994
2020,Pazardzhik,Rakitovo,7854,3864,3990,41.9878,24.0861
2020,Pazardzhik,Septemvri,7198,3511,3687,42.2167,24.1
2020,Pazardzhik,Strelcha,3767,1775,1992,42.5,24.3167
2020,Pazardzhik,Sarnitsa,3356,1697,1659,41.7858,24.015
2020,Pernik,Batanovtsi,1997,991,1006,42.5539,23.0325
2020,Pernik,Breznik,3843,1860,1983,42.7394,22.9078
2020,Pernik,Zemen,1467,753,714,42.48,22.7489
2020,Pernik,Pernik,71504,34140,37364,42.6078,23.0375
2020,Pernik,Radomir,12688,6188,6500,42.5453,22.9775
2020,Pernik,Tran,2289,1148,1141,42.8342,22.6519
2020,Pleven,Belene,6696,3578,3118,43.6511,25.1133
2020,Pleven,Gulyantsi,2816,1360,1456,43.6486,24.7125
2020,Pleven,Dolna Mitropolia,2795,1376,1419,43.4667,24.5333
2020,Pleven,Dolni Dabnik,3821,1817,2004,43.4167,24.4333
2020,Pleven,Iskar,2739,1348,1391,43.4608,24.2686
2020,Pleven,Knezha,9149,4421,4728,43.5,24.0833
2020,Pleven,Koynare,3128,1562,1566,43.3667,24.0833
2020,Pleven,Levski,8567,4042,4525,43.4333,25.1333
2020,Pleven,Nikopol,2765,1345,1420,43.7081,24.8983
2020,Pleven,Pleven,91119,42914,48205,43.4167,24.6167
2020,Pleven,Pordim,1820,897,923,43.4167,24.9167
2020,Pleven,Slavyanovo,3507,1678,1829,43.3167,24.8667
2020,Pleven,Trastenik,3949,1927,2022,43.4833,24.55
2020,Pleven,Cherven Bryag,10961,5356,5605,43.2667,24.1
2020,Plovdiv,Asenovgrad,48236,23131,25105,42.0167,24.8667
2020,Plovdiv,Banya,3093,1432,1661,42.5,24.8333
2020,Plovdiv,Brezovo,1624,816,808,42.4833,25.0833
2020,Plovdiv,Kalofer,2653,1221,1432,42.6178,24.98
2020,Plovdiv,Karlovo,20550,9748,10802,42.6333,24.8
2020,Plovdiv,Klisura,907,414,493,42.7,24.45
2020,Plovdiv,Krichim,7752,3802,3950,42.0333,24.4667
2020,Plovdiv,Kuklen,5891,2885,3006,42.0333,24.7833
2020,Plovdiv,Laki,1761,870,891,41.8167,24.8333
2020,Plovdiv,Perushtitsa,4785,2359,2426,42.0333,24.55
2020,Plovdiv,Plovdiv,342048,161934,180114,42.15,24.75
2020,Plovdiv,Parvomay,11813,5580,6233,42.1,25.2167
2020,Plovdiv,Rakovski,14696,7115,7581,42.2833,24.9333
2020,Plovdiv,Sadovo,2456,1227,1229,42.1333,24.8667
2020,Plovdiv,Sopot,8108,3880,4228,42.6667,24.75
2020,Plovdiv,Stamboliyski,10738,5136,5602,42.1333,24.5333
2020,Plovdiv,Saedinenie,5397,2630,2767,42.25,24.6
2020,Plovdiv,Hisarya,6231,2928,3303,42.5,24.7
2020,Razgrad,Zavet,2608,1281,1327,43.7333,26.5833
2020,Razgrad,Isperih,7868,3833,4035,43.7167,26.8333
2020,Razgrad,Kubrat,6205,2962,3243,43.8,26.5
2020,Razgrad,Loznitsa,1982,961,1021,43.4333,26.6167
2020,Razgrad,Razgrad,29399,13821,15578,43.5333,26.5167
2020,Razgrad,Tsar Kaloyan,3098,1502,1596,43.6333,26.2333
2020,Ruse,Borovo,1735,865,870,43.5667,25.8167
2020,Ruse,Byala,7188,3485,3703,42.8833,27.8833
2020,Ruse,Byala,7188,3485,3703,43.4631,25.7214
2020,Ruse,Vetovo,3986,2030,1956,43.7,26.2667
2020,Ruse,Glodzhevo,3121,1558,1563,43.6833,26.5
2020,Ruse,Dve Mogili,3620,1783,1837,43.5,25.8833
2020,Ruse,Marten,3809,1925,1884,43.85,25.9333
2020,Ruse,Ruse,135440,65269,70171,43.8486,25.9534
2020,Ruse,Senovo,1225,612,613,43.6167,26.3167
2020,Ruse,Slivo pole,2790,1373,1417,43.85,26.2
2020,Ruse,Silistra,46750,22216,24534,44.1167,27.2667
2020,Ruse,Silistra,46750,22216,24534,44.1167,27.2667
2020,Ruse,Alfatar,1336,651,685,43.95,27.3
2020,Ruse,Glavinitsa,1275,597,678,43.9333,26.8333
2020,Ruse,Dulovo,6371,3060,3311,43.8333,27.1333
2020,Ruse,Silistra,30169,14254,15915,44.1167,27.2667
2020,Ruse,Silistra,30169,14254,15915,44.1167,27.2667
2020,Ruse,Tutrakan,7599,3654,3945,44.05,26.6167
2020,Sliven,Kermen,1507,738,769,42.6333,26.1333
2020,Sliven,Kotel,5003,2393,2610,42.8833,26.45
2020,Sliven,Nova Zagora,19939,9602,10337,42.4833,26.0167
2020,Sliven,Sliven,83371,39592,43779,42.6833,26.3167
2020,Sliven,Tvarditsa,5573,2796,2777,42.7167,26.0167
2020,Sliven,Shivachevo,3630,1821,1809,42.7,26.0667
2020,Smolyan,Devin,5874,2752,3122,41.7444,24.3978
2020,Smolyan,Dospat,2032,981,1051,41.6436,24.1667
2020,Smolyan,Zlatograd,6203,2887,3316,41.3833,25.1
2020,Smolyan,Madan,5221,2549,2672,41.4833,24.9333
2020,Smolyan,Nedelino,3697,1778,1919,41.5167,25.1
2020,Smolyan,Rudozem,3363,1640,1723,41.4833,24.85
2020,Smolyan,Smolyan,26718,12655,14063,41.5739,24.7128
2020,Smolyan,Chepelare,4668,2275,2393,41.7269,24.6833
2020,Sofia (stolitsa),Bankya,11403,5544,5859,42.6983,23.1342
2020,Sofia (stolitsa),Buhovo,2528,1272,1256,42.7667,23.4667
2020,Sofia (stolitsa),Novi Iskar,13561,6642,6919,42.8022,23.3006
2020,Sofia (stolitsa),Sofia,1221785,584506,637279,42.6977,23.3219
2020,Sofia (oblast),Bozhurishte,5876,2880,2996,42.755,23.1897
2020,Sofia (oblast),Botevgrad,19012,9016,9996,42.9119,23.8106
2020,Sofia (oblast),Godech,4115,2013,2102,43.0122,23.0447
2020,Sofia (oblast),Dolna Banya,4381,2132,2249,42.3,23.7833
2020,Sofia (oblast),Dragoman,3097,1507,1590,42.9225,23.0464
2020,Sofia (oblast),Elin Pelin,6869,3295,3574,42.6667,23.6
2020,Sofia (oblast),Etropole,9446,4742,4704,42.8333,24.0
2020,Sofia (oblast),Zlatitsa,4386,2114,2272,42.7,24.1333
2020,Sofia (oblast),Ihtiman,12640,6198,6442,42.4333,23.8167
2020,Sofia (oblast),Koprivshtitsa,1962,954,1008,42.6333,24.35
2020,Sofia (oblast),Kostenets,5801,2799,3002,42.3086,23.8578
2020,Sofia (oblast),Kostinbrod,11976,5855,6121,42.8136,23.2178
2020,Sofia (oblast),Momin prohod,1355,643,712,42.4,23.85
2020,Sofia (oblast),Pirdop,6496,3110,3386,42.7,24.1833
2020,Sofia (oblast),Pravets,3761,1852,1909,42.8986,23.9142
2020,Sofia (oblast),Samokov,24942,11967,12975,42.3378,23.5528
2020,Sofia (oblast),Svoge,7496,3683,3813,42.9597,23.3408
2020,Sofia (oblast),Slivnitsa,7030,3479,3551,42.8511,23.0356
2020,Stara Zagora,Gurkovo,2743,1370,1373,42.65,25.8167
2020,Stara Zagora,Galabovo,7034,3528,3506,42.1333,25.8667
2020,Stara Zagora,Kazanlak,44266,20858,23408,42.6167,25.4
2020,Stara Zagora,Kran,2957,1460,1497,42.6658,25.3738
2020,Stara Zagora,Maglizh,3025,1519,1506,42.6167,25.5667
2020,Stara Zagora,Nikolaevo,2751,1376,1375,42.6833,25.85
2020,Stara Zagora,Pavel Banya,2533,1182,1351,42.6167,25.2
2020,Stara Zagora,Radnevo,10984,5382,5602,42.3,25.9333
2020,Stara Zagora,Stara Zagora,125732,59648,66084,42.4258,25.6347
2020,Stara Zagora,Chirpan,13687,6663,7024,42.2,25.3333
2020,Stara Zagora,Shipka,1176,563,613,42.7167,25.3333
2020,Targovishte,Antonovo,1398,681,717,43.15,26.1667
2020,Targovishte,Omurtag,7018,3309,3709,43.1,26.4167
2020,Targovishte,Opaka,2413,1196,1217,43.45,26.1667
2020,Targovishte,Popovo,13624,6498,7126,43.35,26.2333
2020,Targovishte,Targovishte,35139,16646,18493,43.25,26.5833
2020,Haskovo,Dimitrovgrad,32535,15592,16943,42.0519,25.5897
2020,Haskovo,Ivaylovgrad,3102,1536,1566,41.5283,26.1256
2020,Haskovo,Lyubimets,6823,3381,3442,41.8333,26.0833
2020,Haskovo,Madzharovo,576,299,277,41.6292,25.8667
2020,Haskovo,Merichleri,1450,690,760,42.0,25.8
2020,Haskovo,Svilengrad,17108,8426,8682,41.7667,26.2
2020,Haskovo,Simeonovgrad,7125,3607,3518,42.0333,25.8333
2020,Haskovo,Topolovgrad,4645,2269,2376,42.0844,26.3386
2020,Haskovo,Harmanli,19151,9675,9476,41.9333,25.9
2020,Haskovo,Haskovo,68298,32320,35978,41.9333,25.5667
2020,Shumen,Veliki Preslav,6916,3342,3574,43.1667,26.8167
2020,Shumen,Varbitsa,3352,1663,1689,43.1667,26.5833
2020,Shumen,Kaolinovo,1512,769,743,43.3167,27.0167
2020,Shumen,Kaspichan,2712,1322,1390,43.3167,27.1667
2020,Shumen,Novi Pazar,10939,5325,5614,43.35,27.2
2020,Shumen,Pliska,820,391,429,43.3667,27.1167
2020,Shumen,Smyadovo,3629,1759,1870,43.0333,27.05
2020,Shumen,Shumen,72997,34604,38393,43.2714,26.9361
2020,Yambol,Bolyarovo,1077,547,530,42.1,26.8333
2020,Yambol,Elhovo,9121,4403,4718,42.1667,26.5667
2020,Yambol,Straldzha,5482,2772,2710,42.6,26.6833
2020,Yambol,Yambol,64435,30965,33470,42.4833,26.5
2021,Blagoevgrad,Bansko,9459,4594,4865,41.8383,23.488
2021,Blagoevgrad,Belitsa,2915,1422,1493,41.9494,23.5725
2021,Blagoevgrad,Blagoevgrad,67810,32187,35623,42.0167,23.1
2021,Blagoevgrad,Gotse Delchev,18237,8589,9648,41.5667,23.7333
2021,Blagoevgrad,Dobrinishte,2550,1229,1321,41.825,23.5594
2021,Blagoevgrad,Kresna,3216,1618,1598,41.73,23.1569
2021,Blagoevgrad,Melnik,171,92,79,41.5231,23.3925
2021,Blagoevgrad,Petrich,26778,12750,14028,41.3981,23.2072
2021,Blagoevgrad,Razlog,11243,5398,5845,41.8864,23.4678
2021,Blagoevgrad,Sandanski,24511,11581,12930,41.5667,23.2833
2021,Blagoevgrad,Simitli,6194,3085,3109,41.8936,23.1069
2021,Blagoevgrad,Hadzhidimovo,2348,1168,1180,41.5167,23.8667
2021,Blagoevgrad,Yakoruda,5016,2392,2624,42.02,23.6833
2021,Burgas,Aytos,18974,9090,9884,42.7,27.25
2021,Burgas,Aheloy,2295,1144,1151,42.6483,27.6494
2021,Burgas,Ahtopol,1203,593,610,42.1,27.95
2021,Burgas,Burgas,198035,93463,104572,42.4975,27.47
2021,Burgas,Bulgarovo,1536,760,776,42.65,27.3333
2021,Burgas,Kableshkovo,2876,1423,1453,42.6167,27.5667
2021,Burgas,Kameno,4051,1981,2070,42.5667,27.3667
2021,Burgas,Karnobat,16483,7916,8567,42.65,26.9833
2021,Burgas,Kiten,1060,520,540,42.2344,27.7711
2021,Burgas,Malko Tarnovo,1890,943,947,41.9833,27.5333
2021,Burgas,Nesebar,14539,6865,7674,42.66,27.72
2021,Burgas,Obzor,2431,1269,1162,42.8167,27.8833
2021,Burgas,Pomorie,14033,6573,7460,42.55,27.65
2021,Burgas,Primorsko,3062,1537,1525,42.2667,27.75
2021,Burgas,Sveti Vlas,4523,2221,2302,42.7167,27.7667
2021,Burgas,Sozopol,4697,2269,2428,42.4167,27.7
2021,Burgas,Sredets,8270,4100,4170,42.3483,27.1933
2021,Burgas,Sungurlare,2890,1433,1457,42.7667,26.7833
2021,Burgas,Tsarevo,5770,2832,2938,42.17,27.85
2021,Burgas,Chernomorets,2481,1204,1277,42.45,27.64
2021,Varna,Aksakovo,7567,3691,3876,43.2592,27.8211
2021,Varna,Beloslav,7114,3572,3542,43.19,27.7
2021,Varna,Byala,2227,1110,1117,42.8833,27.8833
2021,Varna,Byala,2227,1110,1117,43.4631,25.7214
2021,Varna,Varna,332686,160287,172399,43.2167,27.9167
2021,Varna,Valchi Dol,2736,1345,1391,43.4,27.5333
2021,Varna,Devnya,7685,3842,3843,43.2222,27.57
2021,Varna,Dolni Chiflik,6269,3093,3176,42.9833,27.7333
2021,Varna,Dalgopol,4296,2151,2145,43.05,27.35
2021,Varna,Ignatievo,3919,1901,2018,43.3,27.7
2021,Varna,Provadia,11557,5637,5920,43.1833,27.4333
2021,Varna,Suvorovo,4425,2191,2234,43.33,27.6
2021,Veliko Tarnovo,Byala Cherkva,1628,802,826,43.15,25.3
2021,Veliko Tarnovo,Veliko Tarnovo,65793,30833,34960,43.0833,25.65
2021,Veliko Tarnovo,Gorna Oryahovitsa,27317,13004,14313,43.1278,25.7019
2021,Veliko Tarnovo,Debelets,3603,1759,1844,43.0333,25.6167
2021,Veliko Tarnovo,Dolna Oryahovitsa,2550,1235,1315,43.1167,25.7833
2021,Veliko Tarnovo,Elena,4542,2157,2385,42.9333,25.8833
2021,Veliko Tarnovo,Zlataritsa,2004,992,1012,43.05,25.9
2021,Veliko Tarnovo,Kilifarevo,2106,1028,1078,42.9833,25.6333
2021,Veliko Tarnovo,Lyaskovets,7010,3341,3669,43.1111,25.7261
2021,Veliko Tarnovo,Pavlikeni,8961,4288,4673,43.2428,25.3219
2021,Veliko Tarnovo,Polski Trambesh,3736,1854,1882,43.3667,25.65
2021,Veliko Tarnovo,Svishtov,22917,11246,11671,43.6239,25.3531
2021,Veliko Tarnovo,Strazhitsa,4131,2033,2098,43.2333,25.9667
2021,Veliko Tarnovo,Suhindol,1560,761,799,43.1833,25.2
2021,Vidin,Belogradchik,4233,2059,2174,43.6278,22.6833
2021,Vidin,Bregovo,1963,948,1015,44.15,22.65
2021,Vidin,Vidin,38669,18531,20138,43.99,22.8725
2021,Vidin,Gramada,1144,599,545,43.8742,22.6783
2021,Vidin,Dimovo,980,482,498,43.7417,22.7283
2021,Vidin,Dunavtsi,1753,834,919,44.0,22.8667
2021,Vidin,Kula,2400,1154,1246,43.89,22.5217
2021,Vratsa,Byala Slatina,9277,4465,4812,43.4667,23.9333
2021,Vratsa,Vratsa,50012,23863,26149,43.21,23.5625
2021,Vratsa,Kozloduy,11331,5560,5771,43.7833,23.7333
2021,Vratsa,Krivodol,2502,1215,1287,43.3683,23.4936
2021,Vratsa,Mezdra,8678,4134,4544,43.15,23.7
2021,Vratsa,Mizia,2468,1227,1241,43.6867,23.8458
2021,Vratsa,Oryahovo,3976,1961,2015,43.7358,23.9619
2021,Vratsa,Roman,2390,1156,1234,43.1369,24.125
2021,Gabrovo,Gabrovo,48133,22979,25154,42.8747,25.3186
2021,Gabrovo,Dryanovo,6107,2934,3173,42.9747,25.4781
2021,Gabrovo,Plachkovtsi,1349,666,683,42.8333,25.4333
2021,Gabrovo,Sevlievo,19363,9274,10089,43.0275,25.1125
2021,Gabrovo,Tryavna,7624,3608,4016,42.8672,25.5008
2021,Dobrich,Balchik,10870,5248,5622,43.4072,28.1672
2021,Dobrich,General Toshevo,5830,2835,2995,43.7,28.0333
2021,Dobrich,Dobrich,79269,37471,41798,43.5667,27.8333
2021,Dobrich,Kavarna,10426,5030,5396,43.4358,28.3386
2021,Dobrich,Tervel,5385,2640,2745,43.7472,27.41
2021,Dobrich,Shabla,2954,1439,1515,43.535,28.5339
2021,Kardzhali,Ardino,4088,2018,2070,41.5833,25.1333
2021,Kardzhali,Dzhebel,3391,1662,1729,41.4933,25.305
2021,Kardzhali,Krumovgrad,4868,2310,2558,41.4667,25.65
2021,Kardzhali,Kardzhali,44071,20901,23170,41.65,25.3667
2021,Kardzhali,Momchilgrad,8148,4004,4144,41.5258,25.4061
2021,Kyustendil,Bobovdol,4502,2348,2154,42.3522,23.0333
2021,Kyustendil,Boboshevo,1086,518,568,42.1461,23.0708
2021,Kyustendil,Dupnitsa,28333,13347,14986,42.2667,23.1167
2021,Kyustendil,Kocherinovo,1957,929,1028,42.1167,23.0833
2021,Kyustendil,Kyustendil,37799,18133,19666,42.2833,22.6833
2021,Kyustendil,Rila,1958,961,997,42.13,23.3869
2021,Kyustendil,Sapareva Banya,3396,1682,1714,42.2889,23.2672
2021,Lovech,Apriltsi,2442,1172,1270,42.85,24.9167
2021,Lovech,Letnitsa,2352,1176,1176,43.2558,25.0639
2021,Lovech,Lovech,29659,14130,15529,43.1333,24.7167
2021,Lovech,Lukovit,8105,3923,4182,43.2,24.1667
2021,Lovech,Teteven,8255,4008,4247,42.9167,24.2667
2021,Lovech,Troyan,18449,8863,9586,42.89,24.7133
2021,Lovech,Ugarchin,2294,1155,1139,43.1,24.3167
2021,Lovech,Yablanitsa,2486,1243,1243,43.05,24.1
2021,Montana,Berkovitsa,11372,5498,5874,43.2392,23.1272
2021,Montana,Boychinovtsi,1232,607,625,43.4683,23.3044
2021,Montana,Brusartsi,882,432,450,43.7,23.05
2021,Montana,Valchedram,2890,1370,1520,43.715,23.45
2021,Montana,Varshets,5265,2593,2672,43.1981,23.2875
2021,Montana,Lom,18593,8926,9667,43.8139,23.2369
2021,Montana,Montana,36455,17387,19068,43.4125,23.225
2021,Montana,Chiprovtsi,1454,691,763,43.3844,22.8822
2021,Pazardzhik,Batak,2577,1291,1286,41.9442,24.2181
2021,Pazardzhik,Belovo,3287,1575,1712,42.2122,24.015
2021,Pazardzhik,Bratsigovo,3628,1795,1833,42.0128,24.3742
2021,Pazardzhik,Velingrad,20826,9847,10979,42.0278,23.9908
2021,Pazardzhik,Vetren,2734,1357,1377,42.245,24.0894
2021,Pazardzhik,Kostandovo,3988,1978,2010,42.0656,24.0517
2021,Pazardzhik,Pazardzhik,65671,31411,34260,42.1922,24.3331
2021,Pazardzhik,Panagyurishte,15275,7417,7858,42.5,24.1833
2021,Pazardzhik,Peshtera,15175,7407,7768,42.0347,24.2994
2021,Pazardzhik,Rakitovo,7814,3843,3971,41.9878,24.0861
2021,Pazardzhik,Septemvri,7058,3432,3626,42.2167,24.1
2021,Pazardzhik,Strelcha,3710,1733,1977,42.5,24.3167
2021,Pazardzhik,Sarnitsa,3321,1675,1646,41.7858,24.015
2021,Pernik,Batanovtsi,1973,975,998,42.5539,23.0325
2021,Pernik,Breznik,3735,1810,1925,42.7394,22.9078
2021,Pernik,Zemen,1413,719,694,42.48,22.7489
2021,Pernik,Pernik,70285,33472,36813,42.6078,23.0375
2021,Pernik,Radomir,12462,6064,6398,42.5453,22.9775
2021,Pernik,Tran,2290,1153,1137,42.8342,22.6519
2021,Pleven,Belene,6496,3459,3037,43.6511,25.1133
2021,Pleven,Gulyantsi,2759,1327,1432,43.6486,24.7125
2021,Pleven,Dolna Mitropolia,2742,1354,1388,43.4667,24.5333
2021,Pleven,Dolni Dabnik,3725,1777,1948,43.4167,24.4333
2021,Pleven,Iskar,2700,1323,1377,43.4608,24.2686
2021,Pleven,Knezha,9022,4341,4681,43.5,24.0833
2021,Pleven,Koynare,3050,1514,1536,43.3667,24.0833
2021,Pleven,Levski,8357,3942,4415,43.4333,25.1333
2021,Pleven,Nikopol,2710,1306,1404,43.7081,24.8983
2021,Pleven,Pleven,89823,42219,47604,43.4167,24.6167
2021,Pleven,Pordim,1779,871,908,43.4167,24.9167
2021,Pleven,Slavyanovo,3391,1609,1782,43.3167,24.8667
2021,Pleven,Trastenik,3854,1868,1986,43.4833,24.55
2021,Pleven,Cherven Bryag,10742,5233,5509,43.2667,24.1
2021,Plovdiv,Asenovgrad,47815,22904,24911,42.0167,24.8667
2021,Plovdiv,Banya,3018,1402,1616,42.5,24.8333
2021,Plovdiv,Brezovo,1604,807,797,42.4833,25.0833
2021,Plovdiv,Kalofer,2585,1194,1391,42.6178,24.98
2021,Plovdiv,Karlovo,20251,9614,10637,42.6333,24.8
2021,Plovdiv,Klisura,878,402,476,42.7,24.45
2021,Plovdiv,Krichim,7636,3747,3889,42.0333,24.4667
2021,Plovdiv,Kuklen,5787,2852,2935,42.0333,24.7833
2021,Plovdiv,Laki,1697,834,863,41.8167,24.8333
2021,Plovdiv,Perushtitsa,4735,2323,2412,42.0333,24.55
2021,Plovdiv,Plovdiv,343070,162536,180534,42.15,24.75
2021,Plovdiv,Parvomay,11621,5498,6123,42.1,25.2167
2021,Plovdiv,Rakovski,14679,7093,7586,42.2833,24.9333
2021,Plovdiv,Sadovo,2437,1222,1215,42.1333,24.8667
2021,Plovdiv,Sopot,7935,3792,4143,42.6667,24.75
2021,Plovdiv,Stamboliyski,10573,5069,5504,42.1333,24.5333
2021,Plovdiv,Saedinenie,5290,2573,2717,42.25,24.6
2021,Plovdiv,Hisarya,6142,2873,3269,42.5,24.7
2021,Razgrad,Zavet,2555,1258,1297,43.7333,26.5833
2021,Razgrad,Isperih,7697,3743,3954,43.7167,26.8333
2021,Razgrad,Kubrat,6054,2872,3182,43.8,26.5
2021,Razgrad,Loznitsa,1929,926,1003,43.4333,26.6167
2021,Razgrad,Razgrad,28931,13581,15350,43.5333,26.5167
2021,Razgrad,Tsar Kaloyan,2989,1439,1550,43.6333,26.2333
2021,Ruse,Borovo,1698,840,858,43.5667,25.8167
2021,Ruse,Byala,6991,3395,3596,42.8833,27.8833
2021,Ruse,Byala,6991,3395,3596,43.4631,25.7214
2021,Ruse,Vetovo,3925,1991,1934,43.7,26.2667
2021,Ruse,Glodzhevo,3095,1538,1557,43.6833,26.5
2021,Ruse,Dve Mogili,3579,1762,1817,43.5,25.8833
2021,Ruse,Marten,3720,1862,1858,43.85,25.9333
2021,Ruse,Ruse,133813,64521,69292,43.8486,25.9534
2021,Ruse,Senovo,1196,604,592,43.6167,26.3167
2021,Ruse,Slivo pole,2774,1362,1412,43.85,26.2
2021,Ruse,Silistra,45829,21785,24044,44.1167,27.2667
2021,Ruse,Silistra,45829,21785,24044,44.1167,27.2667
2021,Ruse,Alfatar,1318,655,663,43.95,27.3
2021,Ruse,Glavinitsa,1254,591,663,43.9333,26.8333
2021,Ruse,Dulovo,6281,3026,3255,43.8333,27.1333
2021,Ruse,Silistra,29498,13925,15573,44.1167,27.2667
2021,Ruse,Silistra,29498,13925,15573,44.1167,27.2667
2021,Ruse,Tutrakan,7478,3588,3890,44.05,26.6167
2021,Sliven,Kermen,1489,727,762,42.6333,26.1333
2021,Sliven,Kotel,4924,2350,2574,42.8833,26.45
2021,Sliven,Nova Zagora,19562,9423,10139,42.4833,26.0167
2021,Sliven,Sliven,82251,39034,43217,42.6833,26.3167
2021,Sliven,Tvarditsa,5538,2771,2767,42.7167,26.0167
2021,Sliven,Shivachevo,3630,1820,1810,42.7,26.0667
2021,Smolyan,Devin,5721,2672,3049,41.7444,24.3978
2021,Smolyan,Dospat,1986,955,1031,41.6436,24.1667
2021,Smolyan,Zlatograd,6113,2843,3270,41.3833,25.1
2021,Smolyan,Madan,5129,2500,2629,41.4833,24.9333
2021,Smolyan,Nedelino,3602,1733,1869,41.5167,25.1
2021,Smolyan,Rudozem,3302,1610,1692,41.4833,24.85
2021,Smolyan,Smolyan,26167,12372,13795,41.5739,24.7128
2021,Smolyan,Chepelare,4534,2228,2306,41.7269,24.6833
2021,Sofia (stolitsa),Bankya,11351,5518,5833,42.6983,23.1342
2021,Sofia (stolitsa),Buhovo,2484,1260,1224,42.7667,23.4667
2021,Sofia (stolitsa),Novi Iskar,13445,6555,6890,42.8022,23.3006
2021,Sofia (stolitsa),Sofia,1221172,585521,635651,42.6977,23.3219
2021,Sofia (oblast),Bozhurishte,5811,2855,2956,42.755,23.1897
2021,Sofia (oblast),Botevgrad,18807,8893,9914,42.9119,23.8106
2021,Sofia (oblast),Godech,3991,1958,2033,43.0122,23.0447
2021,Sofia (oblast),Dolna Banya,4318,2107,2211,42.3,23.7833
2021,Sofia (oblast),Dragoman,3034,1470,1564,42.9225,23.0464
2021,Sofia (oblast),Elin Pelin,6755,3232,3523,42.6667,23.6
2021,Sofia (oblast),Etropole,9262,4624,4638,42.8333,24.0
2021,Sofia (oblast),Zlatitsa,4279,2063,2216,42.7,24.1333
2021,Sofia (oblast),Ihtiman,12515,6136,6379,42.4333,23.8167
2021,Sofia (oblast),Koprivshtitsa,1911,937,974,42.6333,24.35
2021,Sofia (oblast),Kostenets,5674,2725,2949,42.3086,23.8578
2021,Sofia (oblast),Kostinbrod,11824,5786,6038,42.8136,23.2178
2021,Sofia (oblast),Momin prohod,1325,622,703,42.4,23.85
2021,Sofia (oblast),Pirdop,6403,3047,3356,42.7,24.1833
2021,Sofia (oblast),Pravets,3739,1842,1897,42.8986,23.9142
2021,Sofia (oblast),Samokov,24629,11807,12822,42.3378,23.5528
2021,Sofia (oblast),Svoge,7361,3597,3764,42.9597,23.3408
2021,Sofia (oblast),Slivnitsa,6909,3415,3494,42.8511,23.0356
2021,Stara Zagora,Gurkovo,2807,1417,1390,42.65,25.8167
2021,Stara Zagora,Galabovo,6876,3442,3434,42.1333,25.8667
2021,Stara Zagora,Kazanlak,43859,20590,23269,42.6167,25.4
2021,Stara Zagora,Kran,2894,1444,1450,42.6658,25.3738
2021,Stara Zagora,Maglizh,2963,1495,1468,42.6167,25.5667
2021,Stara Zagora,Nikolaevo,2720,1357,1363,42.6833,25.85
2021,Stara Zagora,Pavel Banya,2482,1178,1304,42.6167,25.2
2021,Stara Zagora,Radnevo,10784,5290,5494,42.3,25.9333
2021,Stara Zagora,Stara Zagora,124599,59112,65487,42.4258,25.6347
2021,Stara Zagora,Chirpan,13391,6504,6887,42.2,25.3333
2021,Stara Zagora,Shipka,1165,560,605,42.7167,25.3333
2021,Targovishte,Antonovo,1361,660,701,43.15,26.1667
2021,Targovishte,Omurtag,6871,3242,3629,43.1,26.4167
2021,Targovishte,Opaka,2341,1153,1188,43.45,26.1667
2021,Targovishte,Popovo,13324,6359,6965,43.35,26.2333
2021,Targovishte,Targovishte,34793,16444,18349,43.25,26.5833
2021,Haskovo,Dimitrovgrad,31837,15273,16564,42.0519,25.5897
2021,Haskovo,Ivaylovgrad,2943,1446,1497,41.5283,26.1256
2021,Haskovo,Lyubimets,6751,3333,3418,41.8333,26.0833
2021,Haskovo,Madzharovo,567,294,273,41.6292,25.8667
2021,Haskovo,Merichleri,1443,685,758,42.0,25.8
2021,Haskovo,Svilengrad,16959,8347,8612,41.7667,26.2
2021,Haskovo,Simeonovgrad,6994,3534,3460,42.0333,25.8333
2021,Haskovo,Topolovgrad,4553,2204,2349,42.0844,26.3386
2021,Haskovo,Harmanli,18830,9485,9345,41.9333,25.9
2021,Haskovo,Haskovo,67086,31781,35305,41.9333,25.5667
2021,Shumen,Veliki Preslav,6741,3249,3492,43.1667,26.8167
2021,Shumen,Varbitsa,3287,1630,1657,43.1667,26.5833
2021,Shumen,Kaolinovo,1524,775,749,43.3167,27.0167
2021,Shumen,Kaspichan,2681,1320,1361,43.3167,27.1667
2021,Shumen,Novi Pazar,10707,5227,5480,43.35,27.2
2021,Shumen,Pliska,792,376,416,43.3667,27.1167
2021,Shumen,Smyadovo,3565,1724,1841,43.0333,27.05
2021,Shumen,Shumen,72342,34278,38064,43.2714,26.9361
2021,Yambol,Bolyarovo,1063,539,524,42.1,26.8333
2021,Yambol,Elhovo,8947,4320,4627,42.1667,26.5667
2021,Yambol,Straldzha,5397,2739,2658,42.6,26.6833
2021,Yambol,Yambol,63656,30544,33112,42.4833,26.5
2022,Blagoevgrad,Bansko,9220,4448,4772,41.8383,23.488
2022,Blagoevgrad,Belitsa,2959,1439,1520,41.9494,23.5725
2022,Blagoevgrad,Blagoevgrad,62524,29686,32838,42.0167,23.1
2022,Blagoevgrad,Gotse Delchev,17726,8352,9374,41.5667,23.7333
2022,Blagoevgrad,Dobrinishte,2561,1243,1318,41.825,23.5594
2022,Blagoevgrad,Kresna,2897,1431,1466,41.73,23.1569
2022,Blagoevgrad,Melnik,165,85,80,41.5231,23.3925
2022,Blagoevgrad,Petrich,26093,12450,13643,41.3981,23.2072
2022,Blagoevgrad,Razlog,11097,5339,5758,41.8864,23.4678
2022,Blagoevgrad,Sandanski,23844,11291,12553,41.5667,23.2833
2022,Blagoevgrad,Simitli,6218,3075,3143,41.8936,23.1069
2022,Blagoevgrad,Hadzhidimovo,2347,1161,1186,41.5167,23.8667
2022,Blagoevgrad,Yakoruda,4789,2274,2515,42.02,23.6833
2022,Burgas,Aytos,17448,8266,9182,42.7,27.25
2022,Burgas,Aheloy,2390,1175,1215,42.6483,27.6494
2022,Burgas,Ahtopol,1032,493,539,42.1,27.95
2022,Burgas,Burgas,188242,89027,99215,42.4975,27.47
2022,Burgas,Bulgarovo,1516,753,763,42.65,27.3333
2022,Burgas,Kableshkovo,2686,1338,1348,42.6167,27.5667
2022,Burgas,Kameno,3626,1749,1877,42.5667,27.3667
2022,Burgas,Karnobat,14886,7068,7818,42.65,26.9833
2022,Burgas,Kiten,809,405,404,42.2344,27.7711
2022,Burgas,Malko Tarnovo,1611,779,832,41.9833,27.5333
2022,Burgas,Nesebar,12036,5623,6413,42.66,27.72
2022,Burgas,Obzor,2038,1030,1008,42.8167,27.8833
2022,Burgas,Pomorie,12829,6035,6794,42.55,27.65
2022,Burgas,Primorsko,2786,1359,1427,42.2667,27.75
2022,Burgas,Sveti Vlas,3405,1670,1735,42.7167,27.7667
2022,Burgas,Sozopol,4022,1948,2074,42.4167,27.7
2022,Burgas,Sredets,7709,3736,3973,42.3483,27.1933
2022,Burgas,Sungurlare,2726,1345,1381,42.7667,26.7833
2022,Burgas,Tsarevo,5456,2655,2801,42.17,27.85
2022,Burgas,Chernomorets,2001,990,1011,42.45,27.64
2022,Varna,Aksakovo,7064,3455,3609,43.2592,27.8211
2022,Varna,Beloslav,6794,3410,3384,43.19,27.7
2022,Varna,Byala,2053,1009,1044,42.8833,27.8833
2022,Varna,Byala,2053,1009,1044,43.4631,25.7214
2022,Varna,Varna,311093,148010,163083,43.2167,27.9167
2022,Varna,Valchi Dol,2485,1237,1248,43.4,27.5333
2022,Varna,Devnya,6526,3219,3307,43.2222,27.57
2022,Varna,Dolni Chiflik,5400,2651,2749,42.9833,27.7333
2022,Varna,Dalgopol,4148,2051,2097,43.05,27.35
2022,Varna,Ignatievo,3350,1612,1738,43.3,27.7
2022,Varna,Provadia,10079,4810,5269,43.1833,27.4333
2022,Varna,Suvorovo,3884,1928,1956,43.33,27.6
2022,Veliko Tarnovo,Byala Cherkva,1593,776,817,43.15,25.3
2022,Veliko Tarnovo,Veliko Tarnovo,59166,27650,31516,43.0833,25.65
2022,Veliko Tarnovo,Gorna Oryahovitsa,25764,12158,13606,43.1278,25.7019
2022,Veliko Tarnovo,Debelets,3462,1689,1773,43.0333,25.6167
2022,Veliko Tarnovo,Dolna Oryahovitsa,2566,1230,1336,43.1167,25.7833
2022,Veliko Tarnovo,Elena,4442,2107,2335,42.9333,25.8833
2022,Veliko Tarnovo,Zlataritsa,1907,952,955,43.05,25.9
2022,Veliko Tarnovo,Kilifarevo,1700,799,901,42.9833,25.6333
2022,Veliko Tarnovo,Lyaskovets,6821,3220,3601,43.1111,25.7261
2022,Veliko Tarnovo,Pavlikeni,8376,4002,4374,43.2428,25.3219
2022,Veliko Tarnovo,Polski Trambesh,3554,1752,1802,43.3667,25.65
2022,Veliko Tarnovo,Svishtov,17940,8596,9344,43.6239,25.3531
2022,Veliko Tarnovo,Strazhitsa,3775,1835,1940,43.2333,25.9667
2022,Veliko Tarnovo,Suhindol,1436,694,742,43.1833,25.2
2022,Vidin,Belogradchik,3964,1903,2061,43.6278,22.6833
2022,Vidin,Bregovo,1706,818,888,44.15,22.65
2022,Vidin,Vidin,34797,16516,18281,43.99,22.8725
2022,Vidin,Gramada,945,455,490,43.8742,22.6783
2022,Vidin,Dimovo,917,443,474,43.7417,22.7283
2022,Vidin,Dunavtsi,1693,823,870,44.0,22.8667
2022,Vidin,Kula,2341,1116,1225,43.89,22.5217
2022,Vratsa,Byala Slatina,8975,4307,4668,43.4667,23.9333
2022,Vratsa,Vratsa,49569,23559,26010,43.21,23.5625
2022,Vratsa,Kozloduy,10916,5343,5573,43.7833,23.7333
2022,Vratsa,Krivodol,2600,1269,1331,43.3683,23.4936
2022,Vratsa,Mezdra,8558,4068,4490,43.15,23.7
2022,Vratsa,Mizia,2373,1158,1215,43.6867,23.8458
2022,Vratsa,Oryahovo,3787,1861,1926,43.7358,23.9619
2022,Vratsa,Roman,2331,1133,1198,43.1369,24.125
2022,Gabrovo,Gabrovo,44786,21022,23764,42.8747,25.3186
2022,Gabrovo,Dryanovo,5692,2660,3032,42.9747,25.4781
2022,Gabrovo,Plachkovtsi,1276,629,647,42.8333,25.4333
2022,Gabrovo,Sevlievo,17473,8272,9201,43.0275,25.1125
2022,Gabrovo,Tryavna,7180,3366,3814,42.8672,25.5008
2022,Dobrich,Balchik,9291,4467,4824,43.4072,28.1672
2022,Dobrich,General Toshevo,5524,2687,2837,43.7,28.0333
2022,Dobrich,Dobrich,71947,33703,38244,43.5667,27.8333
2022,Dobrich,Kavarna,10216,4885,5331,43.4358,28.3386
2022,Dobrich,Tervel,4598,2246,2352,43.7472,27.41
2022,Dobrich,Shabla,2755,1333,1422,43.535,28.5339
2022,Kardzhali,Ardino,3389,1662,1727,41.5833,25.1333
2022,Kardzhali,Dzhebel,3081,1483,1598,41.4933,25.305
2022,Kardzhali,Krumovgrad,4917,2400,2517,41.4667,25.65
2022,Kardzhali,Kardzhali,40937,19345,21592,41.65,25.3667
2022,Kardzhali,Momchilgrad,7313,3571,3742,41.5258,25.4061
2022,Kyustendil,Bobovdol,4188,2134,2054,42.3522,23.0333
2022,Kyustendil,Boboshevo,955,441,514,42.1461,23.0708
2022,Kyustendil,Dupnitsa,26973,12708,14265,42.2667,23.1167
2022,Kyustendil,Kocherinovo,1938,926,1012,42.1167,23.0833
2022,Kyustendil,Kyustendil,35100,16592,18508,42.2833,22.6833
2022,Kyustendil,Rila,1985,989,996,42.13,23.3869
2022,Kyustendil,Sapareva Banya,3453,1721,1732,42.2889,23.2672
2022,Lovech,Apriltsi,2425,1164,1261,42.85,24.9167
2022,Lovech,Letnitsa,2675,1324,1351,43.2558,25.0639
2022,Lovech,Lovech,27910,13220,14690,43.1333,24.7167
2022,Lovech,Lukovit,7626,3715,3911,43.2,24.1667
2022,Lovech,Teteven,7665,3705,3960,42.9167,24.2667
2022,Lovech,Troyan,17272,8310,8962,42.89,24.7133
2022,Lovech,Ugarchin,2169,1082,1087,43.1,24.3167
2022,Lovech,Yablanitsa,2416,1187,1229,43.05,24.1
2022,Montana,Berkovitsa,9945,4748,5197,43.2392,23.1272
2022,Montana,Boychinovtsi,1359,741,618,43.4683,23.3044
2022,Montana,Brusartsi,873,417,456,43.7,23.05
2022,Montana,Valchedram,2825,1331,1494,43.715,23.45
2022,Montana,Varshets,5308,2621,2687,43.1981,23.2875
2022,Montana,Lom,16297,7731,8566,43.8139,23.2369
2022,Montana,Montana,36633,17576,19057,43.4125,23.225
2022,Montana,Chiprovtsi,1338,632,706,43.3844,22.8822
2022,Pazardzhik,Batak,2601,1323,1278,41.9442,24.2181
2022,Pazardzhik,Belovo,3109,1472,1637,42.2122,24.015
2022,Pazardzhik,Bratsigovo,3336,1644,1692,42.0128,24.3742
2022,Pazardzhik,Velingrad,20031,9424,10607,42.0278,23.9908
2022,Pazardzhik,Vetren,2616,1296,1320,42.245,24.0894
2022,Pazardzhik,Kostandovo,3999,1981,2018,42.0656,24.0517
2022,Pazardzhik,Pazardzhik,55220,26063,29157,42.1922,24.3331
2022,Pazardzhik,Panagyurishte,15281,7415,7866,42.5,24.1833
2022,Pazardzhik,Peshtera,12642,6058,6584,42.0347,24.2994
2022,Pazardzhik,Rakitovo,7012,3472,3540,41.9878,24.0861
2022,Pazardzhik,Septemvri,6068,2922,3146,42.2167,24.1
2022,Pazardzhik,Strelcha,3698,1748,1950,42.5,24.3167
2022,Pazardzhik,Sarnitsa,3353,1702,1651,41.7858,24.015
2022,Pernik,Batanovtsi,1985,960,1025,42.5539,23.0325
2022,Pernik,Breznik,3527,1702,1825,42.7394,22.9078
2022,Pernik,Zemen,1188,591,597,42.48,22.7489
2022,Pernik,Pernik,66991,31562,35429,42.6078,23.0375
2022,Pernik,Radomir,11734,5610,6124,42.5453,22.9775
2022,Pernik,Tran,2176,1087,1089,42.8342,22.6519
2022,Pleven,Belene,6293,3302,2991,43.6511,25.1133
2022,Pleven,Gulyantsi,2556,1225,1331,43.6486,24.7125
2022,Pleven,Dolna Mitropolia,2643,1295,1348,43.4667,24.5333
2022,Pleven,Dolni Dabnik,3617,1729,1888,43.4167,24.4333
2022,Pleven,Iskar,2509,1214,1295,43.4608,24.2686
2022,Pleven,Knezha,9726,4696,5030,43.5,24.0833
2022,Pleven,Koynare,2889,1410,1479,43.3667,24.0833
2022,Pleven,Levski,7387,3516,3871,43.4333,25.1333
2022,Pleven,Nikopol,2298,1087,1211,43.7081,24.8983
2022,Pleven,Pleven,90209,42401,47808,43.4167,24.6167
2022,Pleven,Pordim,1584,754,830,43.4167,24.9167
2022,Pleven,Slavyanovo,2809,1328,1481,43.3167,24.8667
2022,Pleven,Trastenik,3639,1769,1870,43.4833,24.55
2022,Pleven,Cherven Bryag,10533,5094,5439,43.2667,24.1
2022,Plovdiv,Asenovgrad,45473,21571,23902,42.0167,24.8667
2022,Plovdiv,Banya,2958,1356,1602,42.5,24.8333
2022,Plovdiv,Brezovo,1563,775,788,42.4833,25.0833
2022,Plovdiv,Kalofer,2583,1216,1367,42.6178,24.98
2022,Plovdiv,Karlovo,19373,9136,10237,42.6333,24.8
2022,Plovdiv,Klisura,829,385,444,42.7,24.45
2022,Plovdiv,Krichim,7175,3516,3659,42.0333,24.4667
2022,Plovdiv,Kuklen,5575,2713,2862,42.0333,24.7833
2022,Plovdiv,Laki,1590,771,819,41.8167,24.8333
2022,Plovdiv,Perushtitsa,4225,2004,2221,42.0333,24.55
2022,Plovdiv,Plovdiv,321824,151528,170296,42.15,24.75
2022,Plovdiv,Parvomay,11283,5300,5983,42.1,25.2167
2022,Plovdiv,Rakovski,14843,7174,7669,42.2833,24.9333
2022,Plovdiv,Sadovo,2295,1125,1170,42.1333,24.8667
2022,Plovdiv,Sopot,7353,3489,3864,42.6667,24.75
2022,Plovdiv,Stamboliyski,9859,4657,5202,42.1333,24.5333
2022,Plovdiv,Saedinenie,5018,2417,2601,42.25,24.6
2022,Plovdiv,Hisarya,5987,2781,3206,42.5,24.7
2022,Razgrad,Zavet,2311,1107,1204,43.7333,26.5833
2022,Razgrad,Isperih,7274,3452,3822,43.7167,26.8333
2022,Razgrad,Kubrat,5687,2672,3015,43.8,26.5
2022,Razgrad,Loznitsa,1818,882,936,43.4333,26.6167
2022,Razgrad,Razgrad,28509,13268,15241,43.5333,26.5167
2022,Razgrad,Tsar Kaloyan,2735,1304,1431,43.6333,26.2333
2022,Ruse,Borovo,1552,754,798,43.5667,25.8167
2022,Ruse,Byala,6430,3076,3354,42.8833,27.8833
2022,Ruse,Byala,6430,3076,3354,43.4631,25.7214
2022,Ruse,Vetovo,3566,1756,1810,43.7,26.2667
2022,Ruse,Glodzhevo,2763,1342,1421,43.6833,26.5
2022,Ruse,Dve Mogili,3288,1623,1665,43.5,25.8833
2022,Ruse,Marten,3444,1712,1732,43.85,25.9333
2022,Ruse,Ruse,123134,58129,65005,43.8486,25.9534
2022,Ruse,Senovo,1064,540,524,43.6167,26.3167
2022,Ruse,Slivo pole,2362,1161,1201,43.85,26.2
2022,Ruse,Silistra,42803,20162,22641,44.1167,27.2667
2022,Ruse,Silistra,42803,20162,22641,44.1167,27.2667
2022,Ruse,Alfatar,1240,620,620,43.95,27.3
2022,Ruse,Glavinitsa,1210,558,652,43.9333,26.8333
2022,Ruse,Dulovo,5716,2760,2956,43.8333,27.1333
2022,Ruse,Silistra,27727,12942,14785,44.1167,27.2667
2022,Ruse,Silistra,27727,12942,14785,44.1167,27.2667
2022,Ruse,Tutrakan,6910,3282,3628,44.05,26.6167
2022,Sliven,Kermen,1426,690,736,42.6333,26.1333
2022,Sliven,Kotel,4795,2293,2502,42.8833,26.45
2022,Sliven,Nova Zagora,16659,7922,8737,42.4833,26.0167
2022,Sliven,Sliven,79362,37455,41907,42.6833,26.3167
2022,Sliven,Tvarditsa,5571,2794,2777,42.7167,26.0167
2022,Sliven,Shivachevo,3705,1847,1858,42.7,26.0667
2022,Smolyan,Devin,5442,2535,2907,41.7444,24.3978
2022,Smolyan,Dospat,1968,959,1009,41.6436,24.1667
2022,Smolyan,Zlatograd,5697,2632,3065,41.3833,25.1
2022,Smolyan,Madan,4764,2290,2474,41.4833,24.9333
2022,Smolyan,Nedelino,3360,1629,1731,41.5167,25.1
2022,Smolyan,Rudozem,3214,1545,1669,41.4833,24.85
2022,Smolyan,Smolyan,24920,11869,13051,41.5739,24.7128
2022,Smolyan,Chepelare,4199,2052,2147,41.7269,24.6833
2022,Sofia (stolitsa),Bankya,11478,5541,5937,42.6983,23.1342
2022,Sofia (stolitsa),Buhovo,2540,1253,1287,42.7667,23.4667
2022,Sofia (stolitsa),Novi Iskar,13418,6491,6927,42.8022,23.3006
2022,Sofia (stolitsa),Sofia,1190256,566780,623476,42.6977,23.3219
2022,Sofia (oblast),Bozhurishte,5737,2762,2975,42.755,23.1897
2022,Sofia (oblast),Botevgrad,18773,8902,9871,42.9119,23.8106
2022,Sofia (oblast),Godech,3984,1943,2041,43.0122,23.0447
2022,Sofia (oblast),Dolna Banya,4202,2035,2167,42.3,23.7833
2022,Sofia (oblast),Dragoman,2886,1393,1493,42.9225,23.0464
2022,Sofia (oblast),Elin Pelin,6597,3164,3433,42.6667,23.6
2022,Sofia (oblast),Etropole,9261,4546,4715,42.8333,24.0
2022,Sofia (oblast),Zlatitsa,4197,2025,2172,42.7,24.1333
2022,Sofia (oblast),Ihtiman,12638,6203,6435,42.4333,23.8167
2022,Sofia (oblast),Koprivshtitsa,1898,926,972,42.6333,24.35
2022,Sofia (oblast),Kostenets,5783,2781,3002,42.3086,23.8578
2022,Sofia (oblast),Kostinbrod,11759,5698,6061,42.8136,23.2178
2022,Sofia (oblast),Momin prohod,1341,643,698,42.4,23.85
2022,Sofia (oblast),Pirdop,6459,3105,3354,42.7,24.1833
2022,Sofia (oblast),Pravets,3605,1783,1822,42.8986,23.9142
2022,Sofia (oblast),Samokov,24186,11557,12629,42.3378,23.5528
2022,Sofia (oblast),Svoge,7029,3424,3605,42.9597,23.3408
2022,Sofia (oblast),Slivnitsa,6870,3365,3505,42.8511,23.0356
2022,Stara Zagora,Gurkovo,2452,1197,1255,42.65,25.8167
2022,Stara Zagora,Galabovo,6845,3386,3459,42.1333,25.8667
2022,Stara Zagora,Kazanlak,41768,19696,22072,42.6167,25.4
2022,Stara Zagora,Kran,2907,1449,1458,42.6658,25.3738
2022,Stara Zagora,Maglizh,2990,1481,1509,42.6167,25.5667
2022,Stara Zagora,Nikolaevo,2582,1273,1309,42.6833,25.85
2022,Stara Zagora,Pavel Banya,2431,1162,1269,42.6167,25.2
2022,Stara Zagora,Radnevo,10373,5068,5305,42.3,25.9333
2022,Stara Zagora,Stara Zagora,121582,57859,63723,42.4258,25.6347
2022,Stara Zagora,Chirpan,12830,6174,6656,42.2,25.3333
2022,Stara Zagora,Shipka,1194,572,622,42.7167,25.3333
2022,Targovishte,Antonovo,968,475,493,43.15,26.1667
2022,Targovishte,Omurtag,5165,2427,2738,43.1,26.4167
2022,Targovishte,Opaka,2263,1128,1135,43.45,26.1667
2022,Targovishte,Popovo,12709,6095,6614,43.35,26.2333
2022,Targovishte,Targovishte,32957,15592,17365,43.25,26.5833
2022,Haskovo,Dimitrovgrad,31187,14841,16346,42.0519,25.5897
2022,Haskovo,Ivaylovgrad,2875,1418,1457,41.5283,26.1256
2022,Haskovo,Lyubimets,6687,3279,3408,41.8333,26.0833
2022,Haskovo,Madzharovo,475,244,231,41.6292,25.8667
2022,Haskovo,Merichleri,1363,649,714,42.0,25.8
2022,Haskovo,Svilengrad,16583,8061,8522,41.7667,26.2
2022,Haskovo,Simeonovgrad,5893,2878,3015,42.0333,25.8333
2022,Haskovo,Topolovgrad,4466,2133,2333,42.0844,26.3386
2022,Haskovo,Harmanli,15666,7727,7939,41.9333,25.9
2022,Haskovo,Haskovo,64564,30210,34354,41.9333,25.5667
2022,Shumen,Veliki Preslav,5821,2794,3027,43.1667,26.8167
2022,Shumen,Varbitsa,2370,1155,1215,43.1667,26.5833
2022,Shumen,Kaolinovo,1296,666,630,43.3167,27.0167
2022,Shumen,Kaspichan,2469,1198,1271,43.3167,27.1667
2022,Shumen,Novi Pazar,10167,4954,5213,43.35,27.2
2022,Shumen,Pliska,775,381,394,43.3667,27.1167
2022,Shumen,Smyadovo,3383,1660,1723,43.0333,27.05
2022,Shumen,Shumen,67300,31899,35401,43.2714,26.9361
2022,Yambol,Bolyarovo,991,475,516,42.1,26.8333
2022,Yambol,Elhovo,8736,4207,4529,42.1667,26.5667
2022,Yambol,Straldzha,4955,2477,2478,42.6,26.6833
2022,Yambol,Yambol,60641,28945,31696,42.4833,26.5
2023,Blagoevgrad,Bansko,9621,4617,5004,41.8383,23.488
2023,Blagoevgrad,Belitsa,2942,1428,1514,41.9494,23.5725
2023,Blagoevgrad,Blagoevgrad,62346,29482,32864,42.0167,23.1
2023,Blagoevgrad,Gotse Delchev,17623,8264,9359,41.5667,23.7333
2023,Blagoevgrad,Dobrinishte,2556,1241,1315,41.825,23.5594
2023,Blagoevgrad,Kresna,2842,1396,1446,41.73,23.1569
2023,Blagoevgrad,Melnik,194,101,93,41.5231,23.3925
2023,Blagoevgrad,Petrich,26018,12468,13550,41.3981,23.2072
2023,Blagoevgrad,Razlog,11046,5302,5744,41.8864,23.4678
2023,Blagoevgrad,Sandanski,23649,11153,12496,41.5667,23.2833
2023,Blagoevgrad,Simitli,6144,3041,3103,41.8936,23.1069
2023,Blagoevgrad,Hadzhidimovo,2325,1154,1171,41.5167,23.8667
2023,Blagoevgrad,Yakoruda,4741,2253,2488,42.02,23.6833
2023,Burgas,Aytos,17334,8201,9133,42.7,27.25
2023,Burgas,Aheloy,2441,1201,1240,42.6483,27.6494
2023,Burgas,Ahtopol,1040,498,542,42.1,27.95
2023,Burgas,Burgas,188114,88772,99342,42.4975,27.47
2023,Burgas,Bulgarovo,1494,739,755,42.65,27.3333
2023,Burgas,Kableshkovo,2667,1333,1334,42.6167,27.5667
2023,Burgas,Kameno,3593,1735,1858,42.5667,27.3667
2023,Burgas,Karnobat,14537,6888,7649,42.65,26.9833
2023,Burgas,Kiten,997,469,528,42.2344,27.7711
2023,Burgas,Malko Tarnovo,1608,769,839,41.9833,27.5333
2023,Burgas,Nesebar,14770,6777,7993,42.66,27.72
2023,Burgas,Obzor,2089,1053,1036,42.8167,27.8833
2023,Burgas,Pomorie,13378,6258,7120,42.55,27.65
2023,Burgas,Primorsko,3019,1436,1583,42.2667,27.75
2023,Burgas,Sveti Vlas,4688,2259,2429,42.7167,27.7667
2023,Burgas,Sozopol,4231,2047,2184,42.4167,27.7
2023,Burgas,Sredets,7613,3696,3917,42.3483,27.1933
2023,Burgas,Sungurlare,2692,1321,1371,42.7667,26.7833
2023,Burgas,Tsarevo,5405,2623,2782,42.17,27.85
2023,Burgas,Chernomorets,2147,1064,1083,42.45,27.64
2023,Varna,Aksakovo,7006,3431,3575,43.2592,27.8211
2023,Varna,Beloslav,6668,3334,3334,43.19,27.7
2023,Varna,Byala,2232,1086,1146,42.8833,27.8833
2023,Varna,Byala,2232,1086,1146,43.4631,25.7214
2023,Varna,Varna,314607,149340,165267,43.2167,27.9167
2023,Varna,Valchi Dol,2451,1224,1227,43.4,27.5333
2023,Varna,Devnya,6524,3203,3321,43.2222,27.57
2023,Varna,Dolni Chiflik,5341,2617,2724,42.9833,27.7333
2023,Varna,Dalgopol,4129,2035,2094,43.05,27.35
2023,Varna,Ignatievo,3329,1598,1731,43.3,27.7
2023,Varna,Provadia,9847,4708,5139,43.1833,27.4333
2023,Varna,Suvorovo,3861,1912,1949,43.33,27.6
2023,Veliko Tarnovo,Byala Cherkva,1584,762,822,43.15,25.3
2023,Veliko Tarnovo,Veliko Tarnovo,59331,27616,31715,43.0833,25.65
2023,Veliko Tarnovo,Gorna Oryahovitsa,25279,11895,13384,43.1278,25.7019
2023,Veliko Tarnovo,Debelets,3393,1656,1737,43.0333,25.6167
2023,Veliko Tarnovo,Dolna Oryahovitsa,2506,1200,1306,43.1167,25.7833
2023,Veliko Tarnovo,Elena,4327,2045,2282,42.9333,25.8833
2023,Veliko Tarnovo,Zlataritsa,1944,973,971,43.05,25.9
2023,Veliko Tarnovo,Kilifarevo,1684,788,896,42.9833,25.6333
2023,Veliko Tarnovo,Lyaskovets,6691,3149,3542,43.1111,25.7261
2023,Veliko Tarnovo,Pavlikeni,8187,3899,4288,43.2428,25.3219
2023,Veliko Tarnovo,Polski Trambesh,3469,1710,1759,43.3667,25.65
2023,Veliko Tarnovo,Svishtov,17638,8436,9202,43.6239,25.3531
2023,Veliko Tarnovo,Strazhitsa,3678,1791,1887,43.2333,25.9667
2023,Veliko Tarnovo,Suhindol,1428,696,732,43.1833,25.2
2023,Vidin,Belogradchik,3899,1868,2031,43.6278,22.6833
2023,Vidin,Bregovo,1689,806,883,44.15,22.65
2023,Vidin,Vidin,33742,15929,17813,43.99,22.8725
2023,Vidin,Gramada,942,449,493,43.8742,22.6783
2023,Vidin,Dimovo,941,463,478,43.7417,22.7283
2023,Vidin,Dunavtsi,1697,822,875,44.0,22.8667
2023,Vidin,Kula,2283,1094,1189,43.89,22.5217
2023,Vratsa,Byala Slatina,8833,4219,4614,43.4667,23.9333
2023,Vratsa,Vratsa,48406,22848,25558,43.21,23.5625
2023,Vratsa,Kozloduy,10820,5298,5522,43.7833,23.7333
2023,Vratsa,Krivodol,2529,1230,1299,43.3683,23.4936
2023,Vratsa,Mezdra,8308,3923,4385,43.15,23.7
2023,Vratsa,Mizia,2348,1147,1201,43.6867,23.8458
2023,Vratsa,Oryahovo,3734,1831,1903,43.7358,23.9619
2023,Vratsa,Roman,2226,1083,1143,43.1369,24.125
2023,Gabrovo,Gabrovo,44232,20754,23478,42.8747,25.3186
2023,Gabrovo,Dryanovo,5625,2649,2976,42.9747,25.4781
2023,Gabrovo,Plachkovtsi,1259,612,647,42.8333,25.4333
2023,Gabrovo,Sevlievo,17271,8164,9107,43.0275,25.1125
2023,Gabrovo,Tryavna,7069,3330,3739,42.8672,25.5008
2023,Dobrich,Balchik,9379,4496,4883,43.4072,28.1672
2023,Dobrich,General Toshevo,5429,2634,2795,43.7,28.0333
2023,Dobrich,Dobrich,70411,32912,37499,43.5667,27.8333
2023,Dobrich,Kavarna,10111,4832,5279,43.4358,28.3386
2023,Dobrich,Tervel,4513,2196,2317,43.7472,27.41
2023,Dobrich,Shabla,2712,1307,1405,43.535,28.5339
2023,Kardzhali,Ardino,3428,1674,1754,41.5833,25.1333
2023,Kardzhali,Dzhebel,3131,1518,1613,41.4933,25.305
2023,Kardzhali,Krumovgrad,4885,2395,2490,41.4667,25.65
2023,Kardzhali,Kardzhali,41401,19530,21871,41.65,25.3667
2023,Kardzhali,Momchilgrad,7473,3648,3825,41.5258,25.4061
2023,Kyustendil,Bobovdol,4094,2078,2016,42.3522,23.0333
2023,Kyustendil,Boboshevo,984,464,520,42.1461,23.0708
2023,Kyustendil,Dupnitsa,26527,12476,14051,42.2667,23.1167
2023,Kyustendil,Kocherinovo,1918,923,995,42.1167,23.0833
2023,Kyustendil,Kyustendil,34625,16359,18266,42.2833,22.6833
2023,Kyustendil,Rila,1981,976,1005,42.13,23.3869
2023,Kyustendil,Sapareva Banya,3475,1730,1745,42.2889,23.2672
2023,Lovech,Apriltsi,2396,1157,1239,42.85,24.9167
2023,Lovech,Letnitsa,2693,1330,1363,43.2558,25.0639
2023,Lovech,Lovech,27369,12903,14466,43.1333,24.7167
2023,Lovech,Lukovit,7553,3684,3869,43.2,24.1667
2023,Lovech,Teteven,7549,3671,3878,42.9167,24.2667
2023,Lovech,Troyan,16999,8134,8865,42.89,24.7133
2023,Lovech,Ugarchin,2187,1094,1093,43.1,24.3167
2023,Lovech,Yablanitsa,2401,1181,1220,43.05,24.1
2023,Montana,Berkovitsa,9787,4648,5139,43.2392,23.1272
2023,Montana,Boychinovtsi,1341,730,611,43.4683,23.3044
2023,Montana,Brusartsi,872,407,465,43.7,23.05
2023,Montana,Valchedram,2752,1302,1450,43.715,23.45
2023,Montana,Varshets,5244,2579,2665,43.1981,23.2875
2023,Montana,Lom,15959,7560,8399,43.8139,23.2369
2023,Montana,Montana,35468,16980,18488,43.4125,23.225
2023,Montana,Chiprovtsi,1317,626,691,43.3844,22.8822
2023,Pazardzhik,Batak,2575,1321,1254,41.9442,24.2181
2023,Pazardzhik,Belovo,3107,1469,1638,42.2122,24.015
2023,Pazardzhik,Bratsigovo,3281,1617,1664,42.0128,24.3742
2023,Pazardzhik,Velingrad,20015,9392,10623,42.0278,23.9908
2023,Pazardzhik,Vetren,2580,1270,1310,42.245,24.0894
2023,Pazardzhik,Kostandovo,4185,2148,2037,42.0656,24.0517
2023,Pazardzhik,Pazardzhik,54652,25768,28884,42.1922,24.3331
2023,Pazardzhik,Panagyurishte,15095,7285,7810,42.5,24.1833
2023,Pazardzhik,Peshtera,12647,6083,6564,42.0347,24.2994
2023,Pazardzhik,Rakitovo,7417,3791,3626,41.9878,24.0861
2023,Pazardzhik,Septemvri,5979,2865,3114,42.2167,24.1
2023,Pazardzhik,Strelcha,3629,1727,1902,42.5,24.3167
2023,Pazardzhik,Sarnitsa,3350,1701,1649,41.7858,24.015
2023,Pernik,Batanovtsi,1960,943,1017,42.5539,23.0325
2023,Pernik,Breznik,3459,1660,1799,42.7394,22.9078
2023,Pernik,Zemen,1258,630,628,42.48,22.7489
2023,Pernik,Pernik,66261,31172,35089,42.6078,23.0375
2023,Pernik,Radomir,11579,5523,6056,42.5453,22.9775
2023,Pernik,Tran,2146,1069,1077,42.8342,22.6519
2023,Pleven,Belene,6140,3199,2941,43.6511,25.1133
2023,Pleven,Gulyantsi,2514,1201,1313,43.6486,24.7125
2023,Pleven,Dolna Mitropolia,2603,1264,1339,43.4667,24.5333
2023,Pleven,Dolni Dabnik,3611,1723,1888,43.4167,24.4333
2023,Pleven,Iskar,2496,1216,1280,43.4608,24.2686
2023,Pleven,Knezha,9577,4634,4943,43.5,24.0833
2023,Pleven,Koynare,2849,1381,1468,43.3667,24.0833
2023,Pleven,Levski,7263,3439,3824,43.4333,25.1333
2023,Pleven,Nikopol,2241,1066,1175,43.7081,24.8983
2023,Pleven,Pleven,89030,41689,47341,43.4167,24.6167
2023,Pleven,Pordim,1572,739,833,43.4167,24.9167
2023,Pleven,Slavyanovo,2754,1296,1458,43.3167,24.8667
2023,Pleven,Trastenik,3589,1738,1851,43.4833,24.55
2023,Pleven,Cherven Bryag,10303,4981,5322,43.2667,24.1
2023,Plovdiv,Asenovgrad,45322,21482,23840,42.0167,24.8667
2023,Plovdiv,Banya,2892,1320,1572,42.5,24.8333
2023,Plovdiv,Brezovo,1547,769,778,42.4833,25.0833
2023,Plovdiv,Kalofer,2551,1197,1354,42.6178,24.98
2023,Plovdiv,Karlovo,19016,8962,10054,42.6333,24.8
2023,Plovdiv,Klisura,795,374,421,42.7,24.45
2023,Plovdiv,Krichim,7149,3513,3636,42.0333,24.4667
2023,Plovdiv,Kuklen,5567,2716,2851,42.0333,24.7833
2023,Plovdiv,Laki,1552,749,803,41.8167,24.8333
2023,Plovdiv,Perushtitsa,4186,1998,2188,42.0333,24.55
2023,Plovdiv,Plovdiv,325485,153176,172309,42.15,24.75
2023,Plovdiv,Parvomay,11088,5189,5899,42.1,25.2167
2023,Plovdiv,Rakovski,14768,7116,7652,42.2833,24.9333
2023,Plovdiv,Sadovo,2319,1137,1182,42.1333,24.8667
2023,Plovdiv,Sopot,7298,3470,3828,42.6667,24.75
2023,Plovdiv,Stamboliyski,9777,4622,5155,42.1333,24.5333
2023,Plovdiv,Saedinenie,4971,2402,2569,42.25,24.6
2023,Plovdiv,Hisarya,5930,2743,3187,42.5,24.7
2023,Razgrad,Zavet,2279,1098,1181,43.7333,26.5833
2023,Razgrad,Isperih,7163,3401,3762,43.7167,26.8333
2023,Razgrad,Kubrat,5576,2615,2961,43.8,26.5
2023,Razgrad,Loznitsa,1788,867,921,43.4333,26.6167
2023,Razgrad,Razgrad,28234,13109,15125,43.5333,26.5167
2023,Razgrad,Tsar Kaloyan,2646,1259,1387,43.6333,26.2333
2023,Ruse,Borovo,1525,739,786,43.5667,25.8167
2023,Ruse,Byala,6310,3007,3303,42.8833,27.8833
2023,Ruse,Byala,6310,3007,3303,43.4631,25.7214
2023,Ruse,Vetovo,3575,1753,1822,43.7,26.2667
2023,Ruse,Glodzhevo,2781,1343,1438,43.6833,26.5
2023,Ruse,Dve Mogili,3245,1595,1650,43.5,25.8833
2023,Ruse,Marten,3392,1686,1706,43.85,25.9333
2023,Ruse,Ruse,122116,57692,64424,43.8486,25.9534
2023,Ruse,Senovo,1047,530,517,43.6167,26.3167
2023,Ruse,Slivo pole,2341,1148,1193,43.85,26.2
2023,Ruse,Silistra,42184,19855,22329,44.1167,27.2667
2023,Ruse,Silistra,42184,19855,22329,44.1167,27.2667
2023,Ruse,Alfatar,1237,625,612,43.95,27.3
2023,Ruse,Glavinitsa,1179,551,628,43.9333,26.8333
2023,Ruse,Dulovo,5677,2738,2939,43.8333,27.1333
2023,Ruse,Silistra,27270,12715,14555,44.1167,27.2667
2023,Ruse,Silistra,27270,12715,14555,44.1167,27.2667
2023,Ruse,Tutrakan,6821,3226,3595,44.05,26.6167
2023,Sliven,Kermen,1449,701,748,42.6333,26.1333
2023,Sliven,Kotel,4723,2258,2465,42.8833,26.45
2023,Sliven,Nova Zagora,16525,7857,8668,42.4833,26.0167
2023,Sliven,Sliven,78627,37074,41553,42.6833,26.3167
2023,Sliven,Tvarditsa,5550,2793,2757,42.7167,26.0167
2023,Sliven,Shivachevo,3684,1851,1833,42.7,26.0667
2023,Smolyan,Devin,5384,2518,2866,41.7444,24.3978
2023,Smolyan,Dospat,1917,927,990,41.6436,24.1667
2023,Smolyan,Zlatograd,5597,2577,3020,41.3833,25.1
2023,Smolyan,Madan,4704,2250,2454,41.4833,24.9333
2023,Smolyan,Nedelino,3294,1599,1695,41.5167,25.1
2023,Smolyan,Rudozem,3171,1530,1641,41.4833,24.85
2023,Smolyan,Smolyan,24592,11708,12884,41.5739,24.7128
2023,Smolyan,Chepelare,4158,2019,2139,41.7269,24.6833
2023,Sofia (stolitsa),Bankya,11487,5534,5953,42.6983,23.1342
2023,Sofia (stolitsa),Buhovo,2498,1244,1254,42.7667,23.4667
2023,Sofia (stolitsa),Novi Iskar,13384,6473,6911,42.8022,23.3006
2023,Sofia (stolitsa),Sofia,1196806,570669,626137,42.6977,23.3219
2023,Sofia (oblast),Bozhurishte,5709,2755,2954,42.755,23.1897
2023,Sofia (oblast),Botevgrad,18595,8822,9773,42.9119,23.8106
2023,Sofia (oblast),Godech,3963,1937,2026,43.0122,23.0447
2023,Sofia (oblast),Dolna Banya,4226,2040,2186,42.3,23.7833
2023,Sofia (oblast),Dragoman,2845,1381,1464,42.9225,23.0464
2023,Sofia (oblast),Elin Pelin,6608,3169,3439,42.6667,23.6
2023,Sofia (oblast),Etropole,9147,4491,4656,42.8333,24.0
2023,Sofia (oblast),Zlatitsa,4133,1999,2134,42.7,24.1333
2023,Sofia (oblast),Ihtiman,12550,6147,6403,42.4333,23.8167
2023,Sofia (oblast),Koprivshtitsa,1960,960,1000,42.6333,24.35
2023,Sofia (oblast),Kostenets,5725,2744,2981,42.3086,23.8578
2023,Sofia (oblast),Kostinbrod,11708,5670,6038,42.8136,23.2178
2023,Sofia (oblast),Momin prohod,1313,631,682,42.4,23.85
2023,Sofia (oblast),Pirdop,6342,3043,3299,42.7,24.1833
2023,Sofia (oblast),Pravets,3568,1757,1811,42.8986,23.9142
2023,Sofia (oblast),Samokov,24024,11471,12553,42.3378,23.5528
2023,Sofia (oblast),Svoge,6948,3382,3566,42.9597,23.3408
2023,Sofia (oblast),Slivnitsa,6769,3321,3448,42.8511,23.0356
2023,Stara Zagora,Gurkovo,2471,1211,1260,42.65,25.8167
2023,Stara Zagora,Galabovo,6661,3269,3392,42.1333,25.8667
2023,Stara Zagora,Kazanlak,41657,19558,22099,42.6167,25.4
2023,Stara Zagora,Kran,2871,1440,1431,42.6658,25.3738
2023,Stara Zagora,Maglizh,2950,1464,1486,42.6167,25.5667
2023,Stara Zagora,Nikolaevo,2585,1269,1316,42.6833,25.85
2023,Stara Zagora,Pavel Banya,2432,1163,1269,42.6167,25.2
2023,Stara Zagora,Radnevo,10179,4982,5197,42.3,25.9333
2023,Stara Zagora,Stara Zagora,121207,57648,63559,42.4258,25.6347
2023,Stara Zagora,Chirpan,12635,6073,6562,42.2,25.3333
2023,Stara Zagora,Shipka,1178,559,619,42.7167,25.3333
2023,Targovishte,Antonovo,942,465,477,43.15,26.1667
2023,Targovishte,Omurtag,5063,2386,2677,43.1,26.4167
2023,Targovishte,Opaka,2230,1112,1118,43.45,26.1667
2023,Targovishte,Popovo,12507,6005,6502,43.35,26.2333
2023,Targovishte,Targovishte,32728,15471,17257,43.25,26.5833
2023,Haskovo,Dimitrovgrad,30620,14553,16067,42.0519,25.5897
2023,Haskovo,Ivaylovgrad,2794,1380,1414,41.5283,26.1256
2023,Haskovo,Lyubimets,6599,3233,3366,41.8333,26.0833
2023,Haskovo,Madzharovo,518,271,247,41.6292,25.8667
2023,Haskovo,Merichleri,1341,638,703,42.0,25.8
2023,Haskovo,Svilengrad,16497,8027,8470,41.7667,26.2
2023,Haskovo,Simeonovgrad,5860,2867,2993,42.0333,25.8333
2023,Haskovo,Topolovgrad,4402,2096,2306,42.0844,26.3386
2023,Haskovo,Harmanli,15658,7763,7895,41.9333,25.9
2023,Haskovo,Haskovo,63776,29822,33954,41.9333,25.5667
2023,Shumen,Veliki Preslav,5759,2765,2994,43.1667,26.8167
2023,Shumen,Varbitsa,2380,1171,1209,43.1667,26.5833
2023,Shumen,Kaolinovo,1294,661,633,43.3167,27.0167
2023,Shumen,Kaspichan,2452,1190,1262,43.3167,27.1667
2023,Shumen,Novi Pazar,10003,4863,5140,43.35,27.2
2023,Shumen,Pliska,772,386,386,43.3667,27.1167
2023,Shumen,Smyadovo,3369,1633,1736,43.0333,27.05
2023,Shumen,Shumen,66713,31603,35110,43.2714,26.9361
2023,Yambol,Bolyarovo,990,478,512,42.1,26.8333
2023,Yambol,Elhovo,8597,4134,4463,42.1667,26.5667
2023,Yambol,Straldzha,4946,2478,2468,42.6,26.6833
2023,Yambol,Yambol,59755,28437,31318,42.4833,26.5
